"filename", "language", "C#", "UnityAssemblyDefinition", "comment", "blank", "total"
"/Users/hehuan/fork/StarForce/Assets/GameFramework/Scripts/Runtime/Base/BaseComponent.cs", "C#", 314, 0, 48, 64, 426
"/Users/hehuan/fork/StarForce/Assets/GameFramework/Scripts/Runtime/Base/GameEntry.cs", "C#", 92, 0, 35, 21, 148
"/Users/hehuan/fork/StarForce/Assets/GameFramework/Scripts/Runtime/Base/GameFrameworkComponent.cs", "C#", 11, 0, 12, 3, 26
"/Users/hehuan/fork/StarForce/Assets/GameFramework/Scripts/Runtime/Base/ShutdownType.cs", "C#", 9, 0, 18, 4, 31
"/Users/hehuan/fork/StarForce/Assets/GameFramework/Scripts/Runtime/Config/ConfigComponent.cs", "C#", 211, 0, 148, 50, 409
"/Users/hehuan/fork/StarForce/Assets/GameFramework/Scripts/Runtime/Config/ConfigHelperBase.cs", "C#", 14, 0, 48, 7, 69
"/Users/hehuan/fork/StarForce/Assets/GameFramework/Scripts/Runtime/Config/DefaultConfigHelper.cs", "C#", 119, 0, 48, 15, 182
"/Users/hehuan/fork/StarForce/Assets/GameFramework/Scripts/Runtime/Config/LoadConfigDependencyAssetEventArgs.cs", "C#", 67, 0, 41, 12, 120
"/Users/hehuan/fork/StarForce/Assets/GameFramework/Scripts/Runtime/Config/LoadConfigFailureEventArgs.cs", "C#", 51, 0, 35, 10, 96
"/Users/hehuan/fork/StarForce/Assets/GameFramework/Scripts/Runtime/Config/LoadConfigSuccessEventArgs.cs", "C#", 51, 0, 35, 10, 96
"/Users/hehuan/fork/StarForce/Assets/GameFramework/Scripts/Runtime/Config/LoadConfigUpdateEventArgs.cs", "C#", 51, 0, 35, 10, 96
"/Users/hehuan/fork/StarForce/Assets/GameFramework/Scripts/Runtime/DataNode/DataNodeComponent.cs", "C#", 92, 0, 97, 22, 211
"/Users/hehuan/fork/StarForce/Assets/GameFramework/Scripts/Runtime/DataTable/DataRowBase.cs", "C#", 21, 0, 26, 5, 52
"/Users/hehuan/fork/StarForce/Assets/GameFramework/Scripts/Runtime/DataTable/DataTableComponent.cs", "C#", 218, 0, 131, 51, 400
"/Users/hehuan/fork/StarForce/Assets/GameFramework/Scripts/Runtime/DataTable/DataTableHelperBase.cs", "C#", 14, 0, 48, 7, 69
"/Users/hehuan/fork/StarForce/Assets/GameFramework/Scripts/Runtime/DataTable/DefaultDataTableHelper.cs", "C#", 109, 0, 48, 15, 172
"/Users/hehuan/fork/StarForce/Assets/GameFramework/Scripts/Runtime/DataTable/LoadDataTableDependencyAssetEventArgs.cs", "C#", 67, 0, 41, 12, 120
"/Users/hehuan/fork/StarForce/Assets/GameFramework/Scripts/Runtime/DataTable/LoadDataTableFailureEventArgs.cs", "C#", 51, 0, 35, 10, 96
"/Users/hehuan/fork/StarForce/Assets/GameFramework/Scripts/Runtime/DataTable/LoadDataTableSuccessEventArgs.cs", "C#", 51, 0, 35, 10, 96
"/Users/hehuan/fork/StarForce/Assets/GameFramework/Scripts/Runtime/DataTable/LoadDataTableUpdateEventArgs.cs", "C#", 51, 0, 35, 10, 96
"/Users/hehuan/fork/StarForce/Assets/GameFramework/Scripts/Runtime/Debugger/DebuggerActiveWindowType.cs", "C#", 10, 0, 21, 5, 36
"/Users/hehuan/fork/StarForce/Assets/GameFramework/Scripts/Runtime/Debugger/DebuggerComponent.ConsoleWindow.cs", "C#", 438, 0, 6, 66, 510
"/Users/hehuan/fork/StarForce/Assets/GameFramework/Scripts/Runtime/Debugger/DebuggerComponent.EnvironmentInformationWindow.cs", "C#", 85, 0, 6, 6, 97
"/Users/hehuan/fork/StarForce/Assets/GameFramework/Scripts/Runtime/Debugger/DebuggerComponent.FpsCounter.cs", "C#", 68, 0, 6, 10, 84
"/Users/hehuan/fork/StarForce/Assets/GameFramework/Scripts/Runtime/Debugger/DebuggerComponent.GraphicsInformationWindow.cs", "C#", 161, 0, 6, 4, 171
"/Users/hehuan/fork/StarForce/Assets/GameFramework/Scripts/Runtime/Debugger/DebuggerComponent.InputAccelerationInformationWindow.cs", "C#", 35, 0, 6, 6, 47
"/Users/hehuan/fork/StarForce/Assets/GameFramework/Scripts/Runtime/Debugger/DebuggerComponent.InputCompassInformationWindow.cs", "C#", 39, 0, 6, 4, 49
"/Users/hehuan/fork/StarForce/Assets/GameFramework/Scripts/Runtime/Debugger/DebuggerComponent.InputGyroscopeInformationWindow.cs", "C#", 40, 0, 6, 4, 50
"/Users/hehuan/fork/StarForce/Assets/GameFramework/Scripts/Runtime/Debugger/DebuggerComponent.InputLocationInformationWindow.cs", "C#", 41, 0, 6, 4, 51
"/Users/hehuan/fork/StarForce/Assets/GameFramework/Scripts/Runtime/Debugger/DebuggerComponent.InputSummaryInformationWindow.cs", "C#", 31, 0, 6, 3, 40
"/Users/hehuan/fork/StarForce/Assets/GameFramework/Scripts/Runtime/Debugger/DebuggerComponent.InputTouchInformationWindow.cs", "C#", 39, 0, 6, 6, 51
"/Users/hehuan/fork/StarForce/Assets/GameFramework/Scripts/Runtime/Debugger/DebuggerComponent.LogNode.cs", "C#", 78, 0, 37, 11, 126
"/Users/hehuan/fork/StarForce/Assets/GameFramework/Scripts/Runtime/Debugger/DebuggerComponent.NetworkInformationWindow.cs", "C#", 59, 0, 6, 6, 71
"/Users/hehuan/fork/StarForce/Assets/GameFramework/Scripts/Runtime/Debugger/DebuggerComponent.ObjectPoolInformationWindow.cs", "C#", 83, 0, 6, 7, 96
"/Users/hehuan/fork/StarForce/Assets/GameFramework/Scripts/Runtime/Debugger/DebuggerComponent.OperationsWindow.cs", "C#", 54, 0, 6, 7, 67
"/Users/hehuan/fork/StarForce/Assets/GameFramework/Scripts/Runtime/Debugger/DebuggerComponent.PathInformationWindow.cs", "C#", 28, 0, 6, 3, 37
"/Users/hehuan/fork/StarForce/Assets/GameFramework/Scripts/Runtime/Debugger/DebuggerComponent.ProfilerInformationWindow.cs", "C#", 59, 0, 6, 3, 68
"/Users/hehuan/fork/StarForce/Assets/GameFramework/Scripts/Runtime/Debugger/DebuggerComponent.QualityInformationWindow.cs", "C#", 96, 0, 6, 9, 111
"/Users/hehuan/fork/StarForce/Assets/GameFramework/Scripts/Runtime/Debugger/DebuggerComponent.ReferencePoolInformationWindow.cs", "C#", 97, 0, 6, 12, 115
"/Users/hehuan/fork/StarForce/Assets/GameFramework/Scripts/Runtime/Debugger/DebuggerComponent.RuntimeMemoryInformationWindow.Sample.cs", "C#", 55, 0, 6, 7, 68
"/Users/hehuan/fork/StarForce/Assets/GameFramework/Scripts/Runtime/Debugger/DebuggerComponent.RuntimeMemoryInformationWindow.cs", "C#", 121, 0, 6, 16, 143
"/Users/hehuan/fork/StarForce/Assets/GameFramework/Scripts/Runtime/Debugger/DebuggerComponent.RuntimeMemorySummaryWindow.Record.cs", "C#", 50, 0, 6, 6, 62
"/Users/hehuan/fork/StarForce/Assets/GameFramework/Scripts/Runtime/Debugger/DebuggerComponent.RuntimeMemorySummaryWindow.cs", "C#", 109, 0, 6, 16, 131
"/Users/hehuan/fork/StarForce/Assets/GameFramework/Scripts/Runtime/Debugger/DebuggerComponent.SceneInformationWindow.cs", "C#", 35, 0, 6, 4, 45
"/Users/hehuan/fork/StarForce/Assets/GameFramework/Scripts/Runtime/Debugger/DebuggerComponent.ScreenInformationWindow.cs", "C#", 79, 0, 6, 11, 96
"/Users/hehuan/fork/StarForce/Assets/GameFramework/Scripts/Runtime/Debugger/DebuggerComponent.ScrollableDebuggerWindowBase.cs", "C#", 78, 0, 6, 18, 102
"/Users/hehuan/fork/StarForce/Assets/GameFramework/Scripts/Runtime/Debugger/DebuggerComponent.SettingsWindow.cs", "C#", 195, 0, 6, 19, 220
"/Users/hehuan/fork/StarForce/Assets/GameFramework/Scripts/Runtime/Debugger/DebuggerComponent.SystemInformationWindow.cs", "C#", 52, 0, 6, 5, 63
"/Users/hehuan/fork/StarForce/Assets/GameFramework/Scripts/Runtime/Debugger/DebuggerComponent.TimeInformationWindow.cs", "C#", 64, 0, 6, 7, 77
"/Users/hehuan/fork/StarForce/Assets/GameFramework/Scripts/Runtime/Debugger/DebuggerComponent.WebPlayerInformationWindow.cs", "C#", 32, 0, 6, 3, 41
"/Users/hehuan/fork/StarForce/Assets/GameFramework/Scripts/Runtime/Debugger/DebuggerComponent.cs", "C#", 314, 0, 69, 50, 433
"/Users/hehuan/fork/StarForce/Assets/GameFramework/Scripts/Runtime/Download/DownloadAgentHelperBase.cs", "C#", 18, 0, 45, 11, 74
"/Users/hehuan/fork/StarForce/Assets/GameFramework/Scripts/Runtime/Download/DownloadComponent.cs", "C#", 226, 0, 137, 47, 410
"/Users/hehuan/fork/StarForce/Assets/GameFramework/Scripts/Runtime/Download/DownloadFailureEventArgs.cs", "C#", 67, 0, 41, 12, 120
"/Users/hehuan/fork/StarForce/Assets/GameFramework/Scripts/Runtime/Download/DownloadStartEventArgs.cs", "C#", 67, 0, 41, 12, 120
"/Users/hehuan/fork/StarForce/Assets/GameFramework/Scripts/Runtime/Download/DownloadSuccessEventArgs.cs", "C#", 67, 0, 41, 12, 120
"/Users/hehuan/fork/StarForce/Assets/GameFramework/Scripts/Runtime/Download/DownloadUpdateEventArgs.cs", "C#", 67, 0, 41, 12, 120
"/Users/hehuan/fork/StarForce/Assets/GameFramework/Scripts/Runtime/Download/UnityWebRequestDownloadAgentHelper.DownloadHandler.cs", "C#", 36, 0, 6, 7, 49
"/Users/hehuan/fork/StarForce/Assets/GameFramework/Scripts/Runtime/Download/UnityWebRequestDownloadAgentHelper.cs", "C#", 176, 0, 49, 24, 249
"/Users/hehuan/fork/StarForce/Assets/GameFramework/Scripts/Runtime/Download/WWWDownloadAgentHelper.cs", "C#", 168, 0, 49, 30, 247
"/Users/hehuan/fork/StarForce/Assets/GameFramework/Scripts/Runtime/Entity/AttachEntityInfo.cs", "C#", 41, 0, 6, 8, 55
"/Users/hehuan/fork/StarForce/Assets/GameFramework/Scripts/Runtime/Entity/DefaultEntityGroupHelper.cs", "C#", 6, 0, 9, 2, 17
"/Users/hehuan/fork/StarForce/Assets/GameFramework/Scripts/Runtime/Entity/DefaultEntityHelper.cs", "C#", 39, 0, 26, 9, 74
"/Users/hehuan/fork/StarForce/Assets/GameFramework/Scripts/Runtime/Entity/Entity.cs", "C#", 188, 0, 69, 24, 281
"/Users/hehuan/fork/StarForce/Assets/GameFramework/Scripts/Runtime/Entity/EntityComponent.EntityGroup.cs", "C#", 57, 0, 6, 12, 75
"/Users/hehuan/fork/StarForce/Assets/GameFramework/Scripts/Runtime/Entity/EntityComponent.cs", "C#", 583, 0, 432, 132, 1147
"/Users/hehuan/fork/StarForce/Assets/GameFramework/Scripts/Runtime/Entity/EntityGroupHelperBase.cs", "C#", 8, 0, 9, 3, 20
"/Users/hehuan/fork/StarForce/Assets/GameFramework/Scripts/Runtime/Entity/EntityHelperBase.cs", "C#", 11, 0, 26, 5, 42
"/Users/hehuan/fork/StarForce/Assets/GameFramework/Scripts/Runtime/Entity/EntityLogic.cs", "C#", 111, 0, 71, 21, 203
"/Users/hehuan/fork/StarForce/Assets/GameFramework/Scripts/Runtime/Entity/HideEntityCompleteEventArgs.cs", "C#", 60, 0, 38, 11, 109
"/Users/hehuan/fork/StarForce/Assets/GameFramework/Scripts/Runtime/Entity/ShowEntityDependencyAssetEventArgs.cs", "C#", 93, 0, 50, 15, 158
"/Users/hehuan/fork/StarForce/Assets/GameFramework/Scripts/Runtime/Entity/ShowEntityFailureEventArgs.cs", "C#", 78, 0, 44, 13, 135
"/Users/hehuan/fork/StarForce/Assets/GameFramework/Scripts/Runtime/Entity/ShowEntityInfo.cs", "C#", 41, 0, 6, 8, 55
"/Users/hehuan/fork/StarForce/Assets/GameFramework/Scripts/Runtime/Entity/ShowEntitySuccessEventArgs.cs", "C#", 62, 0, 38, 11, 111
"/Users/hehuan/fork/StarForce/Assets/GameFramework/Scripts/Runtime/Entity/ShowEntityUpdateEventArgs.cs", "C#", 77, 0, 44, 13, 134
"/Users/hehuan/fork/StarForce/Assets/GameFramework/Scripts/Runtime/Event/EventComponent.cs", "C#", 68, 0, 53, 15, 136
"/Users/hehuan/fork/StarForce/Assets/GameFramework/Scripts/Runtime/FileSystem/AndroidFileSystemStream.cs", "C#", 199, 0, 57, 38, 294
"/Users/hehuan/fork/StarForce/Assets/GameFramework/Scripts/Runtime/FileSystem/DefaultFileSystemHelper.cs", "C#", 20, 0, 16, 4, 40
"/Users/hehuan/fork/StarForce/Assets/GameFramework/Scripts/Runtime/FileSystem/FileSystemComponent.cs", "C#", 76, 0, 52, 19, 147
"/Users/hehuan/fork/StarForce/Assets/GameFramework/Scripts/Runtime/FileSystem/FileSystemHelperBase.cs", "C#", 9, 0, 16, 3, 28
"/Users/hehuan/fork/StarForce/Assets/GameFramework/Scripts/Runtime/Fsm/FsmComponent.cs", "C#", 114, 0, 129, 27, 270
"/Users/hehuan/fork/StarForce/Assets/GameFramework/Scripts/Runtime/Localization/DefaultLocalizationHelper.cs", "C#", 172, 0, 51, 16, 239
"/Users/hehuan/fork/StarForce/Assets/GameFramework/Scripts/Runtime/Localization/LoadDictionaryDependencyAssetEventArgs.cs", "C#", 67, 0, 41, 12, 120
"/Users/hehuan/fork/StarForce/Assets/GameFramework/Scripts/Runtime/Localization/LoadDictionaryFailureEventArgs.cs", "C#", 51, 0, 35, 10, 96
"/Users/hehuan/fork/StarForce/Assets/GameFramework/Scripts/Runtime/Localization/LoadDictionarySuccessEventArgs.cs", "C#", 51, 0, 35, 10, 96
"/Users/hehuan/fork/StarForce/Assets/GameFramework/Scripts/Runtime/Localization/LoadDictionaryUpdateEventArgs.cs", "C#", 51, 0, 35, 10, 96
"/Users/hehuan/fork/StarForce/Assets/GameFramework/Scripts/Runtime/Localization/LocalizationComponent.cs", "C#", 266, 0, 463, 61, 790
"/Users/hehuan/fork/StarForce/Assets/GameFramework/Scripts/Runtime/Localization/LocalizationHelperBase.cs", "C#", 18, 0, 51, 8, 77
"/Users/hehuan/fork/StarForce/Assets/GameFramework/Scripts/Runtime/Network/NetworkClosedEventArgs.cs", "C#", 36, 0, 29, 8, 73
"/Users/hehuan/fork/StarForce/Assets/GameFramework/Scripts/Runtime/Network/NetworkComponent.cs", "C#", 89, 0, 45, 19, 153
"/Users/hehuan/fork/StarForce/Assets/GameFramework/Scripts/Runtime/Network/NetworkConnectedEventArgs.cs", "C#", 44, 0, 32, 9, 85
"/Users/hehuan/fork/StarForce/Assets/GameFramework/Scripts/Runtime/Network/NetworkCustomErrorEventArgs.cs", "C#", 44, 0, 32, 9, 85
"/Users/hehuan/fork/StarForce/Assets/GameFramework/Scripts/Runtime/Network/NetworkErrorEventArgs.cs", "C#", 59, 0, 38, 11, 108
"/Users/hehuan/fork/StarForce/Assets/GameFramework/Scripts/Runtime/Network/NetworkMissHeartBeatEventArgs.cs", "C#", 44, 0, 32, 9, 85
"/Users/hehuan/fork/StarForce/Assets/GameFramework/Scripts/Runtime/ObjectPool/ObjectPoolComponent.cs", "C#", 372, 0, 571, 91, 1034
"/Users/hehuan/fork/StarForce/Assets/GameFramework/Scripts/Runtime/Procedure/ProcedureComponent.cs", "C#", 91, 0, 38, 20, 149
"/Users/hehuan/fork/StarForce/Assets/GameFramework/Scripts/Runtime/ReferencePool/ReferencePoolComponent.cs", "C#", 49, 0, 15, 9, 73
"/Users/hehuan/fork/StarForce/Assets/GameFramework/Scripts/Runtime/ReferencePool/ReferenceStrictCheckType.cs", "C#", 10, 0, 21, 5, 36
"/Users/hehuan/fork/StarForce/Assets/GameFramework/Scripts/Runtime/Resource/BuiltinVersionListSerializer.LocalVersionListDeserializeCallback.cs", "C#", 81, 0, 24, 10, 115
"/Users/hehuan/fork/StarForce/Assets/GameFramework/Scripts/Runtime/Resource/BuiltinVersionListSerializer.LocalVersionListSerializeCallback.cs", "C#", 97, 0, 27, 12, 136
"/Users/hehuan/fork/StarForce/Assets/GameFramework/Scripts/Runtime/Resource/BuiltinVersionListSerializer.PackageVersionListDeserializeCallback.cs", "C#", 213, 0, 24, 28, 265
"/Users/hehuan/fork/StarForce/Assets/GameFramework/Scripts/Runtime/Resource/BuiltinVersionListSerializer.PackageVersionListSerializeCallback.cs", "C#", 194, 0, 27, 19, 240
"/Users/hehuan/fork/StarForce/Assets/GameFramework/Scripts/Runtime/Resource/BuiltinVersionListSerializer.ResourcePackVersionListDeserializeCallback.cs", "C#", 35, 0, 14, 4, 53
"/Users/hehuan/fork/StarForce/Assets/GameFramework/Scripts/Runtime/Resource/BuiltinVersionListSerializer.ResourcePackVersionListSerializeCallback.cs", "C#", 44, 0, 15, 7, 66
"/Users/hehuan/fork/StarForce/Assets/GameFramework/Scripts/Runtime/Resource/BuiltinVersionListSerializer.UpdatableVersionListDeserializeCallback.cs", "C#", 219, 0, 24, 28, 271
"/Users/hehuan/fork/StarForce/Assets/GameFramework/Scripts/Runtime/Resource/BuiltinVersionListSerializer.UpdatableVersionListSerializeCallback.cs", "C#", 200, 0, 27, 19, 246
"/Users/hehuan/fork/StarForce/Assets/GameFramework/Scripts/Runtime/Resource/BuiltinVersionListSerializer.UpdatableVersionListTryGetValueCallback.cs", "C#", 40, 0, 23, 8, 71
"/Users/hehuan/fork/StarForce/Assets/GameFramework/Scripts/Runtime/Resource/BuiltinVersionListSerializer.cs", "C#", 38, 0, 9, 8, 55
"/Users/hehuan/fork/StarForce/Assets/GameFramework/Scripts/Runtime/Resource/DefaultLoadResourceAgentHelper.cs", "C#", 492, 0, 66, 38, 596
"/Users/hehuan/fork/StarForce/Assets/GameFramework/Scripts/Runtime/Resource/DefaultResourceHelper.cs", "C#", 124, 0, 47, 15, 186
"/Users/hehuan/fork/StarForce/Assets/GameFramework/Scripts/Runtime/Resource/EditorResourceComponent.cs", "C#", 1172, 0, 492, 204, 1868
"/Users/hehuan/fork/StarForce/Assets/GameFramework/Scripts/Runtime/Resource/LoadResourceAgentHelperBase.cs", "C#", 23, 0, 59, 15, 97
"/Users/hehuan/fork/StarForce/Assets/GameFramework/Scripts/Runtime/Resource/ReadWritePathType.cs", "C#", 9, 0, 18, 4, 31
"/Users/hehuan/fork/StarForce/Assets/GameFramework/Scripts/Runtime/Resource/ResourceApplyFailureEventArgs.cs", "C#", 51, 0, 35, 10, 96
"/Users/hehuan/fork/StarForce/Assets/GameFramework/Scripts/Runtime/Resource/ResourceApplyStartEventArgs.cs", "C#", 51, 0, 35, 10, 96
"/Users/hehuan/fork/StarForce/Assets/GameFramework/Scripts/Runtime/Resource/ResourceApplySuccessEventArgs.cs", "C#", 67, 0, 41, 12, 120
"/Users/hehuan/fork/StarForce/Assets/GameFramework/Scripts/Runtime/Resource/ResourceComponent.cs", "C#", 904, 0, 427, 171, 1502
"/Users/hehuan/fork/StarForce/Assets/GameFramework/Scripts/Runtime/Resource/ResourceHelperBase.cs", "C#", 11, 0, 25, 5, 41
"/Users/hehuan/fork/StarForce/Assets/GameFramework/Scripts/Runtime/Resource/ResourceUpdateAllCompleteEventArgs.cs", "C#", 26, 0, 26, 7, 59
"/Users/hehuan/fork/StarForce/Assets/GameFramework/Scripts/Runtime/Resource/ResourceUpdateChangedEventArgs.cs", "C#", 67, 0, 41, 12, 120
"/Users/hehuan/fork/StarForce/Assets/GameFramework/Scripts/Runtime/Resource/ResourceUpdateFailureEventArgs.cs", "C#", 67, 0, 41, 12, 120
"/Users/hehuan/fork/StarForce/Assets/GameFramework/Scripts/Runtime/Resource/ResourceUpdateStartEventArgs.cs", "C#", 75, 0, 44, 13, 132
"/Users/hehuan/fork/StarForce/Assets/GameFramework/Scripts/Runtime/Resource/ResourceUpdateSuccessEventArgs.cs", "C#", 67, 0, 41, 12, 120
"/Users/hehuan/fork/StarForce/Assets/GameFramework/Scripts/Runtime/Resource/ResourceVerifyFailureEventArgs.cs", "C#", 35, 0, 29, 8, 72
"/Users/hehuan/fork/StarForce/Assets/GameFramework/Scripts/Runtime/Resource/ResourceVerifyStartEventArgs.cs", "C#", 43, 0, 32, 9, 84
"/Users/hehuan/fork/StarForce/Assets/GameFramework/Scripts/Runtime/Resource/ResourceVerifySuccessEventArgs.cs", "C#", 43, 0, 32, 9, 84
"/Users/hehuan/fork/StarForce/Assets/GameFramework/Scripts/Runtime/Resource/SceneAsset.cs", "C#", 6, 0, 6, 2, 14
"/Users/hehuan/fork/StarForce/Assets/GameFramework/Scripts/Runtime/Scene/ActiveSceneChangedEventArgs.cs", "C#", 44, 0, 33, 9, 86
"/Users/hehuan/fork/StarForce/Assets/GameFramework/Scripts/Runtime/Scene/LoadSceneDependencyAssetEventArgs.cs", "C#", 67, 0, 41, 12, 120
"/Users/hehuan/fork/StarForce/Assets/GameFramework/Scripts/Runtime/Scene/LoadSceneFailureEventArgs.cs", "C#", 51, 0, 35, 10, 96
"/Users/hehuan/fork/StarForce/Assets/GameFramework/Scripts/Runtime/Scene/LoadSceneSuccessEventArgs.cs", "C#", 51, 0, 35, 10, 96
"/Users/hehuan/fork/StarForce/Assets/GameFramework/Scripts/Runtime/Scene/LoadSceneUpdateEventArgs.cs", "C#", 51, 0, 35, 10, 96
"/Users/hehuan/fork/StarForce/Assets/GameFramework/Scripts/Runtime/Scene/SceneComponent.cs", "C#", 313, 0, 101, 64, 478
"/Users/hehuan/fork/StarForce/Assets/GameFramework/Scripts/Runtime/Scene/UnloadSceneFailureEventArgs.cs", "C#", 43, 0, 32, 9, 84
"/Users/hehuan/fork/StarForce/Assets/GameFramework/Scripts/Runtime/Scene/UnloadSceneSuccessEventArgs.cs", "C#", 43, 0, 32, 9, 84
"/Users/hehuan/fork/StarForce/Assets/GameFramework/Scripts/Runtime/Setting/DefaultSetting.cs", "C#", 172, 0, 108, 34, 314
"/Users/hehuan/fork/StarForce/Assets/GameFramework/Scripts/Runtime/Setting/DefaultSettingHelper.cs", "C#", 198, 0, 151, 39, 388
"/Users/hehuan/fork/StarForce/Assets/GameFramework/Scripts/Runtime/Setting/DefaultSettingSerializer.cs", "C#", 15, 0, 16, 5, 36
"/Users/hehuan/fork/StarForce/Assets/GameFramework/Scripts/Runtime/Setting/PlayerPrefsSettingHelper.cs", "C#", 139, 0, 142, 32, 313
"/Users/hehuan/fork/StarForce/Assets/GameFramework/Scripts/Runtime/Setting/SettingComponent.cs", "C#", 149, 0, 139, 36, 324
"/Users/hehuan/fork/StarForce/Assets/GameFramework/Scripts/Runtime/Setting/SettingHelperBase.cs", "C#", 39, 0, 142, 28, 209
"/Users/hehuan/fork/StarForce/Assets/GameFramework/Scripts/Runtime/Sound/DefaultSoundAgentHelper.cs", "C#", 310, 0, 83, 42, 435
"/Users/hehuan/fork/StarForce/Assets/GameFramework/Scripts/Runtime/Sound/DefaultSoundGroupHelper.cs", "C#", 6, 0, 9, 2, 17
"/Users/hehuan/fork/StarForce/Assets/GameFramework/Scripts/Runtime/Sound/DefaultSoundHelper.cs", "C#", 20, 0, 13, 4, 37
"/Users/hehuan/fork/StarForce/Assets/GameFramework/Scripts/Runtime/Sound/PlaySoundDependencyAssetEventArgs.cs", "C#", 101, 0, 53, 16, 170
"/Users/hehuan/fork/StarForce/Assets/GameFramework/Scripts/Runtime/Sound/PlaySoundFailureEventArgs.cs", "C#", 94, 0, 50, 15, 159
"/Users/hehuan/fork/StarForce/Assets/GameFramework/Scripts/Runtime/Sound/PlaySoundInfo.cs", "C#", 52, 0, 6, 9, 67
"/Users/hehuan/fork/StarForce/Assets/GameFramework/Scripts/Runtime/Sound/PlaySoundSuccessEventArgs.cs", "C#", 78, 0, 44, 13, 135
"/Users/hehuan/fork/StarForce/Assets/GameFramework/Scripts/Runtime/Sound/PlaySoundUpdateEventArgs.cs", "C#", 85, 0, 47, 14, 146
"/Users/hehuan/fork/StarForce/Assets/GameFramework/Scripts/Runtime/Sound/SoundAgentHelperBase.cs", "C#", 82, 0, 83, 24, 189
"/Users/hehuan/fork/StarForce/Assets/GameFramework/Scripts/Runtime/Sound/SoundComponent.SoundGroup.cs", "C#", 57, 0, 6, 12, 75
"/Users/hehuan/fork/StarForce/Assets/GameFramework/Scripts/Runtime/Sound/SoundComponent.cs", "C#", 399, 0, 206, 88, 693
"/Users/hehuan/fork/StarForce/Assets/GameFramework/Scripts/Runtime/Sound/SoundGroupHelperBase.cs", "C#", 22, 0, 12, 4, 38
"/Users/hehuan/fork/StarForce/Assets/GameFramework/Scripts/Runtime/Sound/SoundHelperBase.cs", "C#", 9, 0, 13, 3, 25
"/Users/hehuan/fork/StarForce/Assets/GameFramework/Scripts/Runtime/UI/CloseUIFormCompleteEventArgs.cs", "C#", 60, 0, 38, 11, 109
"/Users/hehuan/fork/StarForce/Assets/GameFramework/Scripts/Runtime/UI/DefaultUIFormHelper.cs", "C#", 40, 0, 26, 9, 75
"/Users/hehuan/fork/StarForce/Assets/GameFramework/Scripts/Runtime/UI/DefaultUIGroupHelper.cs", "C#", 9, 0, 13, 2, 24
"/Users/hehuan/fork/StarForce/Assets/GameFramework/Scripts/Runtime/UI/OpenUIFormDependencyAssetEventArgs.cs", "C#", 91, 0, 50, 15, 156
"/Users/hehuan/fork/StarForce/Assets/GameFramework/Scripts/Runtime/UI/OpenUIFormFailureEventArgs.cs", "C#", 75, 0, 44, 13, 132
"/Users/hehuan/fork/StarForce/Assets/GameFramework/Scripts/Runtime/UI/OpenUIFormSuccessEventArgs.cs", "C#", 51, 0, 35, 10, 96
"/Users/hehuan/fork/StarForce/Assets/GameFramework/Scripts/Runtime/UI/OpenUIFormUpdateEventArgs.cs", "C#", 75, 0, 44, 13, 132
"/Users/hehuan/fork/StarForce/Assets/GameFramework/Scripts/Runtime/UI/UIComponent.UIGroup.cs", "C#", 30, 0, 6, 6, 42
"/Users/hehuan/fork/StarForce/Assets/GameFramework/Scripts/Runtime/UI/UIComponent.cs", "C#", 413, 0, 224, 94, 731
"/Users/hehuan/fork/StarForce/Assets/GameFramework/Scripts/Runtime/UI/UIForm.cs", "C#", 204, 0, 77, 25, 306
"/Users/hehuan/fork/StarForce/Assets/GameFramework/Scripts/Runtime/UI/UIFormHelperBase.cs", "C#", 11, 0, 26, 5, 42
"/Users/hehuan/fork/StarForce/Assets/GameFramework/Scripts/Runtime/UI/UIFormLogic.cs", "C#", 115, 0, 70, 23, 208
"/Users/hehuan/fork/StarForce/Assets/GameFramework/Scripts/Runtime/UI/UIGroupHelperBase.cs", "C#", 9, 0, 13, 3, 25
"/Users/hehuan/fork/StarForce/Assets/GameFramework/Scripts/Runtime/UI/UIIntKey.cs", "C#", 20, 0, 12, 4, 36
"/Users/hehuan/fork/StarForce/Assets/GameFramework/Scripts/Runtime/UI/UIStringKey.cs", "C#", 20, 0, 12, 4, 36
"/Users/hehuan/fork/StarForce/Assets/GameFramework/Scripts/Runtime/UnityGameFramework.Runtime.asmdef", "UnityAssemblyDefinition", 0, 16, 0, 0, 16
"/Users/hehuan/fork/StarForce/Assets/GameFramework/Scripts/Runtime/Utility/BinaryExtension.cs", "C#", 113, 0, 61, 24, 198
"/Users/hehuan/fork/StarForce/Assets/GameFramework/Scripts/Runtime/Utility/DefaultCompressionHelper.cs", "C#", 154, 0, 37, 22, 213
"/Users/hehuan/fork/StarForce/Assets/GameFramework/Scripts/Runtime/Utility/DefaultJsonHelper.cs", "C#", 21, 0, 26, 5, 52
"/Users/hehuan/fork/StarForce/Assets/GameFramework/Scripts/Runtime/Utility/DefaultLogHelper.cs", "C#", 28, 0, 14, 7, 49
"/Users/hehuan/fork/StarForce/Assets/GameFramework/Scripts/Runtime/Utility/DefaultTextHelper.cs", "C#", 195, 0, 361, 37, 593
"/Users/hehuan/fork/StarForce/Assets/GameFramework/Scripts/Runtime/Utility/DefaultVersionHelper.cs", "C#", 22, 0, 15, 4, 41
"/Users/hehuan/fork/StarForce/Assets/GameFramework/Scripts/Runtime/Utility/Helper.cs", "C#", 45, 0, 24, 7, 76
"/Users/hehuan/fork/StarForce/Assets/GameFramework/Scripts/Runtime/Utility/Log.cs", "C#", 818, 0, 1819, 92, 2729
"/Users/hehuan/fork/StarForce/Assets/GameFramework/Scripts/Runtime/Utility/StringExtension.cs", "C#", 44, 0, 15, 8, 67
"/Users/hehuan/fork/StarForce/Assets/GameFramework/Scripts/Runtime/Utility/UnityExtension.cs", "C#", 169, 0, 144, 35, 348
"/Users/hehuan/fork/StarForce/Assets/GameFramework/Scripts/Runtime/Variable/VarBoolean.cs", "C#", 20, 0, 20, 5, 45
"/Users/hehuan/fork/StarForce/Assets/GameFramework/Scripts/Runtime/Variable/VarByte.cs", "C#", 20, 0, 20, 5, 45
"/Users/hehuan/fork/StarForce/Assets/GameFramework/Scripts/Runtime/Variable/VarByteArray.cs", "C#", 20, 0, 20, 5, 45
"/Users/hehuan/fork/StarForce/Assets/GameFramework/Scripts/Runtime/Variable/VarChar.cs", "C#", 20, 0, 20, 5, 45
"/Users/hehuan/fork/StarForce/Assets/GameFramework/Scripts/Runtime/Variable/VarCharArray.cs", "C#", 20, 0, 20, 5, 45
"/Users/hehuan/fork/StarForce/Assets/GameFramework/Scripts/Runtime/Variable/VarColor.cs", "C#", 21, 0, 20, 5, 46
"/Users/hehuan/fork/StarForce/Assets/GameFramework/Scripts/Runtime/Variable/VarColor32.cs", "C#", 21, 0, 20, 5, 46
"/Users/hehuan/fork/StarForce/Assets/GameFramework/Scripts/Runtime/Variable/VarDateTime.cs", "C#", 21, 0, 20, 5, 46
"/Users/hehuan/fork/StarForce/Assets/GameFramework/Scripts/Runtime/Variable/VarDecimal.cs", "C#", 20, 0, 20, 5, 45
"/Users/hehuan/fork/StarForce/Assets/GameFramework/Scripts/Runtime/Variable/VarDouble.cs", "C#", 20, 0, 20, 5, 45
"/Users/hehuan/fork/StarForce/Assets/GameFramework/Scripts/Runtime/Variable/VarGameObject.cs", "C#", 21, 0, 20, 5, 46
"/Users/hehuan/fork/StarForce/Assets/GameFramework/Scripts/Runtime/Variable/VarInt16.cs", "C#", 20, 0, 20, 5, 45
"/Users/hehuan/fork/StarForce/Assets/GameFramework/Scripts/Runtime/Variable/VarInt32.cs", "C#", 20, 0, 20, 5, 45
"/Users/hehuan/fork/StarForce/Assets/GameFramework/Scripts/Runtime/Variable/VarInt64.cs", "C#", 20, 0, 20, 5, 45
"/Users/hehuan/fork/StarForce/Assets/GameFramework/Scripts/Runtime/Variable/VarMaterial.cs", "C#", 21, 0, 20, 5, 46
"/Users/hehuan/fork/StarForce/Assets/GameFramework/Scripts/Runtime/Variable/VarObject.cs", "C#", 10, 0, 12, 3, 25
"/Users/hehuan/fork/StarForce/Assets/GameFramework/Scripts/Runtime/Variable/VarQuaternion.cs", "C#", 21, 0, 20, 5, 46
"/Users/hehuan/fork/StarForce/Assets/GameFramework/Scripts/Runtime/Variable/VarRect.cs", "C#", 21, 0, 20, 5, 46
"/Users/hehuan/fork/StarForce/Assets/GameFramework/Scripts/Runtime/Variable/VarSByte.cs", "C#", 20, 0, 20, 5, 45
"/Users/hehuan/fork/StarForce/Assets/GameFramework/Scripts/Runtime/Variable/VarSingle.cs", "C#", 20, 0, 20, 5, 45
"/Users/hehuan/fork/StarForce/Assets/GameFramework/Scripts/Runtime/Variable/VarString.cs", "C#", 20, 0, 20, 5, 45
"/Users/hehuan/fork/StarForce/Assets/GameFramework/Scripts/Runtime/Variable/VarTexture.cs", "C#", 21, 0, 20, 5, 46
"/Users/hehuan/fork/StarForce/Assets/GameFramework/Scripts/Runtime/Variable/VarTransform.cs", "C#", 21, 0, 20, 5, 46
"/Users/hehuan/fork/StarForce/Assets/GameFramework/Scripts/Runtime/Variable/VarUInt16.cs", "C#", 20, 0, 20, 5, 45
"/Users/hehuan/fork/StarForce/Assets/GameFramework/Scripts/Runtime/Variable/VarUInt32.cs", "C#", 20, 0, 20, 5, 45
"/Users/hehuan/fork/StarForce/Assets/GameFramework/Scripts/Runtime/Variable/VarUInt64.cs", "C#", 20, 0, 20, 5, 45
"/Users/hehuan/fork/StarForce/Assets/GameFramework/Scripts/Runtime/Variable/VarUnityObject.cs", "C#", 21, 0, 20, 5, 46
"/Users/hehuan/fork/StarForce/Assets/GameFramework/Scripts/Runtime/Variable/VarVector2.cs", "C#", 21, 0, 20, 5, 46
"/Users/hehuan/fork/StarForce/Assets/GameFramework/Scripts/Runtime/Variable/VarVector3.cs", "C#", 21, 0, 20, 5, 46
"/Users/hehuan/fork/StarForce/Assets/GameFramework/Scripts/Runtime/Variable/VarVector4.cs", "C#", 21, 0, 20, 5, 46
"/Users/hehuan/fork/StarForce/Assets/GameFramework/Scripts/Runtime/WebRequest/UnityWebRequestAgentHelper.cs", "C#", 133, 0, 36, 18, 187
"/Users/hehuan/fork/StarForce/Assets/GameFramework/Scripts/Runtime/WebRequest/WWWFormInfo.cs", "C#", 41, 0, 6, 8, 55
"/Users/hehuan/fork/StarForce/Assets/GameFramework/Scripts/Runtime/WebRequest/WWWWebRequestAgentHelper.cs", "C#", 112, 0, 36, 19, 167
"/Users/hehuan/fork/StarForce/Assets/GameFramework/Scripts/Runtime/WebRequest/WebRequestAgentHelperBase.cs", "C#", 14, 0, 29, 7, 50
"/Users/hehuan/fork/StarForce/Assets/GameFramework/Scripts/Runtime/WebRequest/WebRequestComponent.cs", "C#", 256, 0, 250, 59, 565
"/Users/hehuan/fork/StarForce/Assets/GameFramework/Scripts/Runtime/WebRequest/WebRequestFailureEventArgs.cs", "C#", 61, 0, 38, 11, 110
"/Users/hehuan/fork/StarForce/Assets/GameFramework/Scripts/Runtime/WebRequest/WebRequestStartEventArgs.cs", "C#", 52, 0, 35, 10, 97
"/Users/hehuan/fork/StarForce/Assets/GameFramework/Scripts/Runtime/WebRequest/WebRequestSuccessEventArgs.cs", "C#", 61, 0, 39, 12, 112
"Total", "-", 20085, 16, 12190, 3597, 35888