"filename", "language", "C#", "UnityAssemblyDefinition", "comment", "blank", "total"
"/Users/hehuan/fork/StarForce/Assets/GameFramework/Libraries/GameFramework/Base/DataProvider/DataProvider.cs", "C#", 347, 0, 101, 56, 504
"/Users/hehuan/fork/StarForce/Assets/GameFramework/Libraries/GameFramework/Base/DataProvider/DataProviderCreator.cs", "C#", 38, 0, 31, 9, 78
"/Users/hehuan/fork/StarForce/Assets/GameFramework/Libraries/GameFramework/Base/DataProvider/IDataProvider.cs", "C#", 21, 0, 79, 16, 116
"/Users/hehuan/fork/StarForce/Assets/GameFramework/Libraries/GameFramework/Base/DataProvider/IDataProviderHelper.cs", "C#", 11, 0, 48, 6, 65
"/Users/hehuan/fork/StarForce/Assets/GameFramework/Libraries/GameFramework/Base/DataProvider/ReadDataDependencyAssetEventArgs.cs", "C#", 57, 0, 39, 9, 105
"/Users/hehuan/fork/StarForce/Assets/GameFramework/Libraries/GameFramework/Base/DataProvider/ReadDataFailureEventArgs.cs", "C#", 41, 0, 31, 7, 79
"/Users/hehuan/fork/StarForce/Assets/GameFramework/Libraries/GameFramework/Base/DataProvider/ReadDataSuccessEventArgs.cs", "C#", 41, 0, 31, 7, 79
"/Users/hehuan/fork/StarForce/Assets/GameFramework/Libraries/GameFramework/Base/DataProvider/ReadDataUpdateEventArgs.cs", "C#", 41, 0, 31, 7, 79
"/Users/hehuan/fork/StarForce/Assets/GameFramework/Libraries/GameFramework/Base/DataStruct/TypeNamePair.cs", "C#", 67, 0, 54, 15, 136
"/Users/hehuan/fork/StarForce/Assets/GameFramework/Libraries/GameFramework/Base/EventPool/BaseEventArgs.cs", "C#", 10, 0, 12, 2, 24
"/Users/hehuan/fork/StarForce/Assets/GameFramework/Libraries/GameFramework/Base/EventPool/EventPool.Event.cs", "C#", 42, 0, 9, 7, 58
"/Users/hehuan/fork/StarForce/Assets/GameFramework/Libraries/GameFramework/Base/EventPool/EventPool.cs", "C#", 186, 0, 71, 29, 286
"/Users/hehuan/fork/StarForce/Assets/GameFramework/Libraries/GameFramework/Base/EventPool/EventPoolMode.cs", "C#", 12, 0, 21, 6, 39
"/Users/hehuan/fork/StarForce/Assets/GameFramework/Libraries/GameFramework/Base/GameFrameworkAction.cs", "C#", 20, 0, 329, 18, 367
"/Users/hehuan/fork/StarForce/Assets/GameFramework/Libraries/GameFramework/Base/GameFrameworkEntry.cs", "C#", 83, 0, 34, 17, 134
"/Users/hehuan/fork/StarForce/Assets/GameFramework/Libraries/GameFramework/Base/GameFrameworkEventArgs.cs", "C#", 11, 0, 15, 4, 30
"/Users/hehuan/fork/StarForce/Assets/GameFramework/Libraries/GameFramework/Base/GameFrameworkException.cs", "C#", 25, 0, 26, 6, 57
"/Users/hehuan/fork/StarForce/Assets/GameFramework/Libraries/GameFramework/Base/GameFrameworkFunc.cs", "C#", 20, 0, 363, 18, 401
"/Users/hehuan/fork/StarForce/Assets/GameFramework/Libraries/GameFramework/Base/GameFrameworkLinkedList.cs", "C#", 250, 0, 155, 49, 454
"/Users/hehuan/fork/StarForce/Assets/GameFramework/Libraries/GameFramework/Base/GameFrameworkLinkedListRange.cs", "C#", 130, 0, 63, 25, 218
"/Users/hehuan/fork/StarForce/Assets/GameFramework/Libraries/GameFramework/Base/GameFrameworkModule.cs", "C#", 15, 0, 21, 4, 40
"/Users/hehuan/fork/StarForce/Assets/GameFramework/Libraries/GameFramework/Base/GameFrameworkMultiDictionary.cs", "C#", 165, 0, 89, 30, 284
"/Users/hehuan/fork/StarForce/Assets/GameFramework/Libraries/GameFramework/Base/GameFrameworkSerializer.cs", "C#", 110, 0, 75, 24, 209
"/Users/hehuan/fork/StarForce/Assets/GameFramework/Libraries/GameFramework/Base/Log/GameFrameworkLog.ILogHelper.cs", "C#", 10, 0, 14, 2, 26
"/Users/hehuan/fork/StarForce/Assets/GameFramework/Libraries/GameFramework/Base/Log/GameFrameworkLog.cs", "C#", 731, 0, 1733, 183, 2647
"/Users/hehuan/fork/StarForce/Assets/GameFramework/Libraries/GameFramework/Base/Log/GameFrameworkLogLevel.cs", "C#", 11, 0, 24, 6, 41
"/Users/hehuan/fork/StarForce/Assets/GameFramework/Libraries/GameFramework/Base/ReferencePool/IReference.cs", "C#", 7, 0, 12, 2, 21
"/Users/hehuan/fork/StarForce/Assets/GameFramework/Libraries/GameFramework/Base/ReferencePool/ReferencePool.ReferenceCollection.cs", "C#", 172, 0, 6, 25, 203
"/Users/hehuan/fork/StarForce/Assets/GameFramework/Libraries/GameFramework/Base/ReferencePool/ReferencePool.cs", "C#", 135, 0, 64, 27, 226
"/Users/hehuan/fork/StarForce/Assets/GameFramework/Libraries/GameFramework/Base/ReferencePool/ReferencePoolInfo.cs", "C#", 75, 0, 40, 11, 126
"/Users/hehuan/fork/StarForce/Assets/GameFramework/Libraries/GameFramework/Base/TaskPool/ITaskAgent.cs", "C#", 15, 0, 32, 7, 54
"/Users/hehuan/fork/StarForce/Assets/GameFramework/Libraries/GameFramework/Base/TaskPool/StartTaskStatus.cs", "C#", 10, 0, 21, 5, 36
"/Users/hehuan/fork/StarForce/Assets/GameFramework/Libraries/GameFramework/Base/TaskPool/TaskBase.cs", "C#", 82, 0, 43, 13, 138
"/Users/hehuan/fork/StarForce/Assets/GameFramework/Libraries/GameFramework/Base/TaskPool/TaskInfo.cs", "C#", 98, 0, 39, 17, 154
"/Users/hehuan/fork/StarForce/Assets/GameFramework/Libraries/GameFramework/Base/TaskPool/TaskPool.cs", "C#", 311, 0, 81, 53, 445
"/Users/hehuan/fork/StarForce/Assets/GameFramework/Libraries/GameFramework/Base/TaskPool/TaskStatus.cs", "C#", 9, 0, 18, 4, 31
"/Users/hehuan/fork/StarForce/Assets/GameFramework/Libraries/GameFramework/Base/Variable/GenericVariable.cs", "C#", 46, 0, 34, 10, 90
"/Users/hehuan/fork/StarForce/Assets/GameFramework/Libraries/GameFramework/Base/Variable/Variable.cs", "C#", 17, 0, 26, 7, 50
"/Users/hehuan/fork/StarForce/Assets/GameFramework/Libraries/GameFramework/Base/Version/Version.IVersionHelper.cs", "C#", 17, 0, 15, 3, 35
"/Users/hehuan/fork/StarForce/Assets/GameFramework/Libraries/GameFramework/Base/Version/Version.cs", "C#", 41, 0, 22, 9, 72
"/Users/hehuan/fork/StarForce/Assets/GameFramework/Libraries/GameFramework/Config/ConfigManager.ConfigData.cs", "C#", 50, 0, 6, 8, 64
"/Users/hehuan/fork/StarForce/Assets/GameFramework/Libraries/GameFramework/Config/ConfigManager.cs", "C#", 250, 0, 185, 53, 488
"/Users/hehuan/fork/StarForce/Assets/GameFramework/Libraries/GameFramework/Config/IConfigHelper.cs", "C#", 6, 0, 9, 2, 17
"/Users/hehuan/fork/StarForce/Assets/GameFramework/Libraries/GameFramework/Config/IConfigManager.cs", "C#", 33, 0, 106, 22, 161
"/Users/hehuan/fork/StarForce/Assets/GameFramework/Libraries/GameFramework/DataNode/DataNodeManager.DataNode.cs", "C#", 235, 0, 99, 50, 384
"/Users/hehuan/fork/StarForce/Assets/GameFramework/Libraries/GameFramework/DataNode/DataNodeManager.cs", "C#", 141, 0, 110, 30, 281
"/Users/hehuan/fork/StarForce/Assets/GameFramework/Libraries/GameFramework/DataNode/IDataNode.cs", "C#", 39, 0, 91, 22, 152
"/Users/hehuan/fork/StarForce/Assets/GameFramework/Libraries/GameFramework/DataNode/IDataNodeManager.cs", "C#", 25, 0, 94, 17, 136
"/Users/hehuan/fork/StarForce/Assets/GameFramework/Libraries/GameFramework/DataTable/DataTableBase.cs", "C#", 139, 0, 135, 31, 305
"/Users/hehuan/fork/StarForce/Assets/GameFramework/Libraries/GameFramework/DataTable/DataTableManager.DataTable.cs", "C#", 337, 0, 125, 63, 525
"/Users/hehuan/fork/StarForce/Assets/GameFramework/Libraries/GameFramework/DataTable/DataTableManager.cs", "C#", 293, 0, 150, 66, 509
"/Users/hehuan/fork/StarForce/Assets/GameFramework/Libraries/GameFramework/DataTable/IDataRow.cs", "C#", 12, 0, 26, 4, 42
"/Users/hehuan/fork/StarForce/Assets/GameFramework/Libraries/GameFramework/DataTable/IDataTable.cs", "C#", 52, 0, 116, 25, 193
"/Users/hehuan/fork/StarForce/Assets/GameFramework/Libraries/GameFramework/DataTable/IDataTableHelper.cs", "C#", 6, 0, 9, 2, 17
"/Users/hehuan/fork/StarForce/Assets/GameFramework/Libraries/GameFramework/DataTable/IDataTableManager.cs", "C#", 42, 0, 141, 29, 212
"/Users/hehuan/fork/StarForce/Assets/GameFramework/Libraries/GameFramework/Debugger/DebuggerManager.DebuggerWindowGroup.cs", "C#", 208, 0, 62, 38, 308
"/Users/hehuan/fork/StarForce/Assets/GameFramework/Libraries/GameFramework/Debugger/DebuggerManager.cs", "C#", 76, 0, 51, 15, 142
"/Users/hehuan/fork/StarForce/Assets/GameFramework/Libraries/GameFramework/Debugger/IDebuggerManager.cs", "C#", 19, 0, 36, 7, 62
"/Users/hehuan/fork/StarForce/Assets/GameFramework/Libraries/GameFramework/Debugger/IDebuggerWindow.cs", "C#", 12, 0, 30, 7, 49
"/Users/hehuan/fork/StarForce/Assets/GameFramework/Libraries/GameFramework/Debugger/IDebuggerWindowGroup.cs", "C#", 22, 0, 31, 7, 60
"/Users/hehuan/fork/StarForce/Assets/GameFramework/Libraries/GameFramework/Download/Constant.cs", "C#", 7, 0, 12, 2, 21
"/Users/hehuan/fork/StarForce/Assets/GameFramework/Libraries/GameFramework/Download/DownloadAgentHelperCompleteEventArgs.cs", "C#", 29, 0, 23, 6, 58
"/Users/hehuan/fork/StarForce/Assets/GameFramework/Libraries/GameFramework/Download/DownloadAgentHelperErrorEventArgs.cs", "C#", 33, 0, 27, 6, 66
"/Users/hehuan/fork/StarForce/Assets/GameFramework/Libraries/GameFramework/Download/DownloadAgentHelperUpdateBytesEventArgs.cs", "C#", 53, 0, 31, 11, 95
"/Users/hehuan/fork/StarForce/Assets/GameFramework/Libraries/GameFramework/Download/DownloadAgentHelperUpdateLengthEventArgs.cs", "C#", 29, 0, 23, 6, 58
"/Users/hehuan/fork/StarForce/Assets/GameFramework/Libraries/GameFramework/Download/DownloadFailureEventArgs.cs", "C#", 57, 0, 39, 9, 105
"/Users/hehuan/fork/StarForce/Assets/GameFramework/Libraries/GameFramework/Download/DownloadManager.DownloadAgent.cs", "C#", 272, 0, 57, 47, 376
"/Users/hehuan/fork/StarForce/Assets/GameFramework/Libraries/GameFramework/Download/DownloadManager.DownloadCounter.DownloadCounterNode.cs", "C#", 50, 0, 6, 9, 65
"/Users/hehuan/fork/StarForce/Assets/GameFramework/Libraries/GameFramework/Download/DownloadManager.DownloadCounter.cs", "C#", 142, 0, 6, 23, 171
"/Users/hehuan/fork/StarForce/Assets/GameFramework/Libraries/GameFramework/Download/DownloadManager.DownloadTask.cs", "C#", 88, 0, 44, 12, 144
"/Users/hehuan/fork/StarForce/Assets/GameFramework/Libraries/GameFramework/Download/DownloadManager.DownloadTaskStatus.cs", "C#", 13, 0, 21, 5, 39
"/Users/hehuan/fork/StarForce/Assets/GameFramework/Libraries/GameFramework/Download/DownloadManager.cs", "C#", 281, 0, 161, 45, 487
"/Users/hehuan/fork/StarForce/Assets/GameFramework/Libraries/GameFramework/Download/DownloadStartEventArgs.cs", "C#", 57, 0, 39, 9, 105
"/Users/hehuan/fork/StarForce/Assets/GameFramework/Libraries/GameFramework/Download/DownloadSuccessEventArgs.cs", "C#", 57, 0, 39, 9, 105
"/Users/hehuan/fork/StarForce/Assets/GameFramework/Libraries/GameFramework/Download/DownloadUpdateEventArgs.cs", "C#", 57, 0, 39, 9, 105
"/Users/hehuan/fork/StarForce/Assets/GameFramework/Libraries/GameFramework/Download/IDownloadAgentHelper.cs", "C#", 15, 0, 42, 10, 67
"/Users/hehuan/fork/StarForce/Assets/GameFramework/Libraries/GameFramework/Download/IDownloadManager.cs", "C#", 64, 0, 146, 31, 241
"/Users/hehuan/fork/StarForce/Assets/GameFramework/Libraries/GameFramework/Entity/EntityManager.EntityGroup.cs", "C#", 260, 0, 91, 44, 395
"/Users/hehuan/fork/StarForce/Assets/GameFramework/Libraries/GameFramework/Entity/EntityManager.EntityInfo.cs", "C#", 110, 0, 9, 18, 137
"/Users/hehuan/fork/StarForce/Assets/GameFramework/Libraries/GameFramework/Entity/EntityManager.EntityInstanceObject.cs", "C#", 43, 0, 9, 9, 61
"/Users/hehuan/fork/StarForce/Assets/GameFramework/Libraries/GameFramework/Entity/EntityManager.EntityStatus.cs", "C#", 18, 0, 9, 2, 29
"/Users/hehuan/fork/StarForce/Assets/GameFramework/Libraries/GameFramework/Entity/EntityManager.ShowEntityInfo.cs", "C#", 64, 0, 6, 9, 79
"/Users/hehuan/fork/StarForce/Assets/GameFramework/Libraries/GameFramework/Entity/EntityManager.cs", "C#", 846, 0, 323, 159, 1328
"/Users/hehuan/fork/StarForce/Assets/GameFramework/Libraries/GameFramework/Entity/HideEntityCompleteEventArgs.cs", "C#", 49, 0, 35, 8, 92
"/Users/hehuan/fork/StarForce/Assets/GameFramework/Libraries/GameFramework/Entity/IEntity.cs", "C#", 31, 0, 66, 14, 111
"/Users/hehuan/fork/StarForce/Assets/GameFramework/Libraries/GameFramework/Entity/IEntityGroup.cs", "C#", 49, 0, 78, 19, 146
"/Users/hehuan/fork/StarForce/Assets/GameFramework/Libraries/GameFramework/Entity/IEntityGroupHelper.cs", "C#", 6, 0, 9, 2, 17
"/Users/hehuan/fork/StarForce/Assets/GameFramework/Libraries/GameFramework/Entity/IEntityHelper.cs", "C#", 9, 0, 26, 4, 39
"/Users/hehuan/fork/StarForce/Assets/GameFramework/Libraries/GameFramework/Entity/IEntityManager.cs", "C#", 79, 0, 307, 65, 451
"/Users/hehuan/fork/StarForce/Assets/GameFramework/Libraries/GameFramework/Entity/ShowEntityDependencyAssetEventArgs.cs", "C#", 73, 0, 47, 11, 131
"/Users/hehuan/fork/StarForce/Assets/GameFramework/Libraries/GameFramework/Entity/ShowEntityFailureEventArgs.cs", "C#", 57, 0, 39, 9, 105
"/Users/hehuan/fork/StarForce/Assets/GameFramework/Libraries/GameFramework/Entity/ShowEntitySuccessEventArgs.cs", "C#", 41, 0, 31, 7, 79
"/Users/hehuan/fork/StarForce/Assets/GameFramework/Libraries/GameFramework/Entity/ShowEntityUpdateEventArgs.cs", "C#", 57, 0, 39, 9, 105
"/Users/hehuan/fork/StarForce/Assets/GameFramework/Libraries/GameFramework/Event/EventManager.cs", "C#", 69, 0, 65, 16, 150
"/Users/hehuan/fork/StarForce/Assets/GameFramework/Libraries/GameFramework/Event/GameEventArgs.cs", "C#", 6, 0, 9, 2, 17
"/Users/hehuan/fork/StarForce/Assets/GameFramework/Libraries/GameFramework/Event/IEventManager.cs", "C#", 22, 0, 50, 11, 83
"/Users/hehuan/fork/StarForce/Assets/GameFramework/Libraries/GameFramework/FileSystem/CommonFileSystemStream.cs", "C#", 84, 0, 60, 19, 163
"/Users/hehuan/fork/StarForce/Assets/GameFramework/Libraries/GameFramework/FileSystem/FileInfo.cs", "C#", 57, 0, 27, 11, 95
"/Users/hehuan/fork/StarForce/Assets/GameFramework/Libraries/GameFramework/FileSystem/FileSystem.BlockData.cs", "C#", 57, 0, 9, 11, 77
"/Users/hehuan/fork/StarForce/Assets/GameFramework/Libraries/GameFramework/FileSystem/FileSystem.HeaderData.cs", "C#", 81, 0, 9, 16, 106
"/Users/hehuan/fork/StarForce/Assets/GameFramework/Libraries/GameFramework/FileSystem/FileSystem.StringData.cs", "C#", 50, 0, 9, 12, 71
"/Users/hehuan/fork/StarForce/Assets/GameFramework/Libraries/GameFramework/FileSystem/FileSystem.cs", "C#", 971, 0, 219, 192, 1382
"/Users/hehuan/fork/StarForce/Assets/GameFramework/Libraries/GameFramework/FileSystem/FileSystemAccess.cs", "C#", 12, 0, 21, 6, 39
"/Users/hehuan/fork/StarForce/Assets/GameFramework/Libraries/GameFramework/FileSystem/FileSystemManager.cs", "C#", 178, 0, 68, 38, 284
"/Users/hehuan/fork/StarForce/Assets/GameFramework/Libraries/GameFramework/FileSystem/FileSystemStream.cs", "C#", 50, 0, 68, 18, 136
"/Users/hehuan/fork/StarForce/Assets/GameFramework/Libraries/GameFramework/FileSystem/IFileSystem.cs", "C#", 51, 0, 194, 33, 278
"/Users/hehuan/fork/StarForce/Assets/GameFramework/Libraries/GameFramework/FileSystem/IFileSystemHelper.cs", "C#", 7, 0, 16, 2, 25
"/Users/hehuan/fork/StarForce/Assets/GameFramework/Libraries/GameFramework/FileSystem/IFileSystemManager.cs", "C#", 19, 0, 53, 11, 83
"/Users/hehuan/fork/StarForce/Assets/GameFramework/Libraries/GameFramework/Fsm/Fsm.cs", "C#", 374, 0, 138, 77, 589
"/Users/hehuan/fork/StarForce/Assets/GameFramework/Libraries/GameFramework/Fsm/FsmBase.cs", "C#", 56, 0, 44, 14, 114
"/Users/hehuan/fork/StarForce/Assets/GameFramework/Libraries/GameFramework/Fsm/FsmManager.cs", "C#", 221, 0, 142, 49, 412
"/Users/hehuan/fork/StarForce/Assets/GameFramework/Libraries/GameFramework/Fsm/FsmState.cs", "C#", 51, 0, 46, 14, 111
"/Users/hehuan/fork/StarForce/Assets/GameFramework/Libraries/GameFramework/Fsm/IFsm.cs", "C#", 54, 0, 102, 24, 180
"/Users/hehuan/fork/StarForce/Assets/GameFramework/Libraries/GameFramework/Fsm/IFsmManager.cs", "C#", 32, 0, 127, 23, 182
"/Users/hehuan/fork/StarForce/Assets/GameFramework/Libraries/GameFramework/GameFramework.asmdef", "UnityAssemblyDefinition", 0, 14, 0, 0, 14
"/Users/hehuan/fork/StarForce/Assets/GameFramework/Libraries/GameFramework/Localization/ILocalizationHelper.cs", "C#", 10, 0, 12, 2, 24
"/Users/hehuan/fork/StarForce/Assets/GameFramework/Libraries/GameFramework/Localization/ILocalizationManager.cs", "C#", 51, 0, 421, 33, 505
"/Users/hehuan/fork/StarForce/Assets/GameFramework/Libraries/GameFramework/Localization/Language.cs", "C#", 57, 0, 162, 52, 271
"/Users/hehuan/fork/StarForce/Assets/GameFramework/Libraries/GameFramework/Localization/LocalizationManager.cs", "C#", 488, 0, 501, 77, 1066
"/Users/hehuan/fork/StarForce/Assets/GameFramework/Libraries/GameFramework/Network/AddressFamily.cs", "C#", 9, 0, 18, 4, 31
"/Users/hehuan/fork/StarForce/Assets/GameFramework/Libraries/GameFramework/Network/INetworkChannel.cs", "C#", 69, 0, 75, 21, 165
"/Users/hehuan/fork/StarForce/Assets/GameFramework/Libraries/GameFramework/Network/INetworkChannelHelper.cs", "C#", 18, 0, 46, 10, 74
"/Users/hehuan/fork/StarForce/Assets/GameFramework/Libraries/GameFramework/Network/INetworkManager.cs", "C#", 23, 0, 57, 14, 94
"/Users/hehuan/fork/StarForce/Assets/GameFramework/Libraries/GameFramework/Network/IPacketHandler.cs", "C#", 11, 0, 17, 3, 31
"/Users/hehuan/fork/StarForce/Assets/GameFramework/Libraries/GameFramework/Network/IPacketHeader.cs", "C#", 10, 0, 12, 2, 24
"/Users/hehuan/fork/StarForce/Assets/GameFramework/Libraries/GameFramework/Network/NetworkClosedEventArgs.cs", "C#", 25, 0, 23, 5, 53
"/Users/hehuan/fork/StarForce/Assets/GameFramework/Libraries/GameFramework/Network/NetworkConnectedEventArgs.cs", "C#", 33, 0, 27, 6, 66
"/Users/hehuan/fork/StarForce/Assets/GameFramework/Libraries/GameFramework/Network/NetworkCustomErrorEventArgs.cs", "C#", 33, 0, 27, 6, 66
"/Users/hehuan/fork/StarForce/Assets/GameFramework/Libraries/GameFramework/Network/NetworkErrorCode.cs", "C#", 15, 0, 36, 10, 61
"/Users/hehuan/fork/StarForce/Assets/GameFramework/Libraries/GameFramework/Network/NetworkErrorEventArgs.cs", "C#", 50, 0, 35, 9, 94
"/Users/hehuan/fork/StarForce/Assets/GameFramework/Libraries/GameFramework/Network/NetworkManager.ConnectState.cs", "C#", 31, 0, 6, 6, 43
"/Users/hehuan/fork/StarForce/Assets/GameFramework/Libraries/GameFramework/Network/NetworkManager.HeartBeatState.cs", "C#", 46, 0, 6, 7, 59
"/Users/hehuan/fork/StarForce/Assets/GameFramework/Libraries/GameFramework/Network/NetworkManager.NetworkChannelBase.cs", "C#", 462, 0, 95, 80, 637
"/Users/hehuan/fork/StarForce/Assets/GameFramework/Libraries/GameFramework/Network/NetworkManager.ReceiveState.cs", "C#", 78, 0, 6, 15, 99
"/Users/hehuan/fork/StarForce/Assets/GameFramework/Libraries/GameFramework/Network/NetworkManager.SendState.cs", "C#", 52, 0, 6, 10, 68
"/Users/hehuan/fork/StarForce/Assets/GameFramework/Libraries/GameFramework/Network/NetworkManager.TcpNetworkChannel.cs", "C#", 231, 0, 23, 37, 291
"/Users/hehuan/fork/StarForce/Assets/GameFramework/Libraries/GameFramework/Network/NetworkManager.TcpWithSyncReceiveNetworkChannel.cs", "C#", 210, 0, 23, 34, 267
"/Users/hehuan/fork/StarForce/Assets/GameFramework/Libraries/GameFramework/Network/NetworkManager.cs", "C#", 251, 0, 68, 35, 354
"/Users/hehuan/fork/StarForce/Assets/GameFramework/Libraries/GameFramework/Network/NetworkMissHeartBeatEventArgs.cs", "C#", 33, 0, 27, 6, 66
"/Users/hehuan/fork/StarForce/Assets/GameFramework/Libraries/GameFramework/Network/Packet.cs", "C#", 6, 0, 9, 2, 17
"/Users/hehuan/fork/StarForce/Assets/GameFramework/Libraries/GameFramework/Network/ServiceType.cs", "C#", 8, 0, 15, 3, 26
"/Users/hehuan/fork/StarForce/Assets/GameFramework/Libraries/GameFramework/ObjectPool/IObjectPool.cs", "C#", 69, 0, 120, 30, 219
"/Users/hehuan/fork/StarForce/Assets/GameFramework/Libraries/GameFramework/ObjectPool/IObjectPoolManager.cs", "C#", 96, 0, 569, 87, 752
"/Users/hehuan/fork/StarForce/Assets/GameFramework/Libraries/GameFramework/ObjectPool/ObjectBase.cs", "C#", 117, 0, 71, 20, 208
"/Users/hehuan/fork/StarForce/Assets/GameFramework/Libraries/GameFramework/ObjectPool/ObjectInfo.cs", "C#", 73, 0, 39, 11, 123
"/Users/hehuan/fork/StarForce/Assets/GameFramework/Libraries/GameFramework/ObjectPool/ObjectPoolBase.cs", "C#", 72, 0, 60, 21, 153
"/Users/hehuan/fork/StarForce/Assets/GameFramework/Libraries/GameFramework/ObjectPool/ObjectPoolManager.Object.cs", "C#", 120, 0, 58, 19, 197
"/Users/hehuan/fork/StarForce/Assets/GameFramework/Libraries/GameFramework/ObjectPool/ObjectPoolManager.ObjectPool.cs", "C#", 437, 0, 127, 74, 638
"/Users/hehuan/fork/StarForce/Assets/GameFramework/Libraries/GameFramework/ObjectPool/ObjectPoolManager.cs", "C#", 588, 0, 584, 132, 1304
"/Users/hehuan/fork/StarForce/Assets/GameFramework/Libraries/GameFramework/ObjectPool/ReleaseObjectFilterCallback.cs", "C#", 6, 0, 14, 3, 23
"/Users/hehuan/fork/StarForce/Assets/GameFramework/Libraries/GameFramework/Procedure/IProcedureManager.cs", "C#", 23, 0, 48, 11, 82
"/Users/hehuan/fork/StarForce/Assets/GameFramework/Libraries/GameFramework/Procedure/ProcedureBase.cs", "C#", 28, 0, 32, 7, 67
"/Users/hehuan/fork/StarForce/Assets/GameFramework/Libraries/GameFramework/Procedure/ProcedureManager.cs", "C#", 116, 0, 63, 26, 205
"/Users/hehuan/fork/StarForce/Assets/GameFramework/Libraries/GameFramework/Properties/AssemblyInfo.cs", "C#", 14, 0, 19, 6, 39
"/Users/hehuan/fork/StarForce/Assets/GameFramework/Libraries/GameFramework/Resource/ApplyResourcesCompleteCallback.cs", "C#", 4, 0, 11, 2, 17
"/Users/hehuan/fork/StarForce/Assets/GameFramework/Libraries/GameFramework/Resource/CheckResourcesCompleteCallback.cs", "C#", 4, 0, 14, 2, 20
"/Users/hehuan/fork/StarForce/Assets/GameFramework/Libraries/GameFramework/Resource/CheckVersionListResult.cs", "C#", 8, 0, 15, 3, 26
"/Users/hehuan/fork/StarForce/Assets/GameFramework/Libraries/GameFramework/Resource/Constant.cs", "C#", 7, 0, 12, 2, 21
"/Users/hehuan/fork/StarForce/Assets/GameFramework/Libraries/GameFramework/Resource/DecryptResourceCallback.cs", "C#", 4, 0, 20, 2, 26
"/Users/hehuan/fork/StarForce/Assets/GameFramework/Libraries/GameFramework/Resource/HasAssetResult.cs", "C#", 12, 0, 27, 7, 46
"/Users/hehuan/fork/StarForce/Assets/GameFramework/Libraries/GameFramework/Resource/ILoadResourceAgentHelper.cs", "C#", 21, 0, 59, 15, 95
"/Users/hehuan/fork/StarForce/Assets/GameFramework/Libraries/GameFramework/Resource/IResourceGroup.cs", "C#", 45, 0, 44, 13, 102
"/Users/hehuan/fork/StarForce/Assets/GameFramework/Libraries/GameFramework/Resource/IResourceGroupCollection.cs", "C#", 42, 0, 45, 13, 100
"/Users/hehuan/fork/StarForce/Assets/GameFramework/Libraries/GameFramework/Resource/IResourceHelper.cs", "C#", 9, 0, 25, 4, 38
"/Users/hehuan/fork/StarForce/Assets/GameFramework/Libraries/GameFramework/Resource/IResourceManager.cs", "C#", 235, 0, 488, 110, 833
"/Users/hehuan/fork/StarForce/Assets/GameFramework/Libraries/GameFramework/Resource/InitResourcesCompleteCallback.cs", "C#", 4, 0, 9, 2, 15
"/Users/hehuan/fork/StarForce/Assets/GameFramework/Libraries/GameFramework/Resource/LoadAssetCallbacks.cs", "C#", 73, 0, 59, 14, 146
"/Users/hehuan/fork/StarForce/Assets/GameFramework/Libraries/GameFramework/Resource/LoadAssetDependencyAssetCallback.cs", "C#", 4, 0, 14, 2, 20
"/Users/hehuan/fork/StarForce/Assets/GameFramework/Libraries/GameFramework/Resource/LoadAssetFailureCallback.cs", "C#", 4, 0, 13, 2, 19
"/Users/hehuan/fork/StarForce/Assets/GameFramework/Libraries/GameFramework/Resource/LoadAssetSuccessCallback.cs", "C#", 4, 0, 13, 2, 19
"/Users/hehuan/fork/StarForce/Assets/GameFramework/Libraries/GameFramework/Resource/LoadAssetUpdateCallback.cs", "C#", 4, 0, 12, 2, 18
"/Users/hehuan/fork/StarForce/Assets/GameFramework/Libraries/GameFramework/Resource/LoadBinaryCallbacks.cs", "C#", 35, 0, 24, 7, 66
"/Users/hehuan/fork/StarForce/Assets/GameFramework/Libraries/GameFramework/Resource/LoadBinaryFailureCallback.cs", "C#", 4, 0, 13, 2, 19
"/Users/hehuan/fork/StarForce/Assets/GameFramework/Libraries/GameFramework/Resource/LoadBinarySuccessCallback.cs", "C#", 4, 0, 13, 2, 19
"/Users/hehuan/fork/StarForce/Assets/GameFramework/Libraries/GameFramework/Resource/LoadBytesCallbacks.cs", "C#", 35, 0, 24, 7, 66
"/Users/hehuan/fork/StarForce/Assets/GameFramework/Libraries/GameFramework/Resource/LoadBytesFailureCallback.cs", "C#", 4, 0, 12, 2, 18
"/Users/hehuan/fork/StarForce/Assets/GameFramework/Libraries/GameFramework/Resource/LoadBytesSuccessCallback.cs", "C#", 4, 0, 13, 2, 19
"/Users/hehuan/fork/StarForce/Assets/GameFramework/Libraries/GameFramework/Resource/LoadResourceAgentHelperErrorEventArgs.cs", "C#", 33, 0, 27, 6, 66
"/Users/hehuan/fork/StarForce/Assets/GameFramework/Libraries/GameFramework/Resource/LoadResourceAgentHelperLoadCompleteEventArgs.cs", "C#", 25, 0, 23, 5, 53
"/Users/hehuan/fork/StarForce/Assets/GameFramework/Libraries/GameFramework/Resource/LoadResourceAgentHelperParseBytesCompleteEventArgs.cs", "C#", 25, 0, 23, 5, 53
"/Users/hehuan/fork/StarForce/Assets/GameFramework/Libraries/GameFramework/Resource/LoadResourceAgentHelperReadBytesCompleteEventArgs.cs", "C#", 25, 0, 24, 6, 55
"/Users/hehuan/fork/StarForce/Assets/GameFramework/Libraries/GameFramework/Resource/LoadResourceAgentHelperReadFileCompleteEventArgs.cs", "C#", 25, 0, 23, 5, 53
"/Users/hehuan/fork/StarForce/Assets/GameFramework/Libraries/GameFramework/Resource/LoadResourceAgentHelperUpdateEventArgs.cs", "C#", 33, 0, 27, 6, 66
"/Users/hehuan/fork/StarForce/Assets/GameFramework/Libraries/GameFramework/Resource/LoadResourceProgress.cs", "C#", 11, 0, 24, 6, 41
"/Users/hehuan/fork/StarForce/Assets/GameFramework/Libraries/GameFramework/Resource/LoadResourceStatus.cs", "C#", 12, 0, 27, 7, 46
"/Users/hehuan/fork/StarForce/Assets/GameFramework/Libraries/GameFramework/Resource/LoadSceneCallbacks.cs", "C#", 73, 0, 59, 14, 146
"/Users/hehuan/fork/StarForce/Assets/GameFramework/Libraries/GameFramework/Resource/LoadSceneDependencyAssetCallback.cs", "C#", 4, 0, 14, 2, 20
"/Users/hehuan/fork/StarForce/Assets/GameFramework/Libraries/GameFramework/Resource/LoadSceneFailureCallback.cs", "C#", 4, 0, 13, 2, 19
"/Users/hehuan/fork/StarForce/Assets/GameFramework/Libraries/GameFramework/Resource/LoadSceneSuccessCallback.cs", "C#", 4, 0, 12, 2, 18
"/Users/hehuan/fork/StarForce/Assets/GameFramework/Libraries/GameFramework/Resource/LoadSceneUpdateCallback.cs", "C#", 4, 0, 12, 2, 18
"/Users/hehuan/fork/StarForce/Assets/GameFramework/Libraries/GameFramework/Resource/LocalVersionList.FileSystem.cs", "C#", 34, 0, 21, 8, 63
"/Users/hehuan/fork/StarForce/Assets/GameFramework/Libraries/GameFramework/Resource/LocalVersionList.Resource.cs", "C#", 72, 0, 36, 11, 119
"/Users/hehuan/fork/StarForce/Assets/GameFramework/Libraries/GameFramework/Resource/LocalVersionList.cs", "C#", 42, 0, 25, 10, 77
"/Users/hehuan/fork/StarForce/Assets/GameFramework/Libraries/GameFramework/Resource/PackageVersionList.Asset.cs", "C#", 34, 0, 21, 8, 63
"/Users/hehuan/fork/StarForce/Assets/GameFramework/Libraries/GameFramework/Resource/PackageVersionList.FileSystem.cs", "C#", 34, 0, 21, 8, 63
"/Users/hehuan/fork/StarForce/Assets/GameFramework/Libraries/GameFramework/Resource/PackageVersionList.Resource.cs", "C#", 79, 0, 41, 13, 133
"/Users/hehuan/fork/StarForce/Assets/GameFramework/Libraries/GameFramework/Resource/PackageVersionList.ResourceGroup.cs", "C#", 34, 0, 21, 8, 63
"/Users/hehuan/fork/StarForce/Assets/GameFramework/Libraries/GameFramework/Resource/PackageVersionList.cs", "C#", 90, 0, 43, 18, 151
"/Users/hehuan/fork/StarForce/Assets/GameFramework/Libraries/GameFramework/Resource/PackageVersionListSerializer.cs", "C#", 14, 0, 16, 4, 34
"/Users/hehuan/fork/StarForce/Assets/GameFramework/Libraries/GameFramework/Resource/ReadOnlyVersionListSerializer.cs", "C#", 14, 0, 16, 4, 34
"/Users/hehuan/fork/StarForce/Assets/GameFramework/Libraries/GameFramework/Resource/ReadWriteVersionListSerializer.cs", "C#", 14, 0, 16, 4, 34
"/Users/hehuan/fork/StarForce/Assets/GameFramework/Libraries/GameFramework/Resource/ResourceApplyFailureEventArgs.cs", "C#", 41, 0, 31, 7, 79
"/Users/hehuan/fork/StarForce/Assets/GameFramework/Libraries/GameFramework/Resource/ResourceApplyStartEventArgs.cs", "C#", 41, 0, 31, 7, 79
"/Users/hehuan/fork/StarForce/Assets/GameFramework/Libraries/GameFramework/Resource/ResourceApplySuccessEventArgs.cs", "C#", 57, 0, 39, 9, 105
"/Users/hehuan/fork/StarForce/Assets/GameFramework/Libraries/GameFramework/Resource/ResourceManager.AssetInfo.cs", "C#", 36, 0, 25, 6, 67
"/Users/hehuan/fork/StarForce/Assets/GameFramework/Libraries/GameFramework/Resource/ResourceManager.LoadType.cs", "C#", 16, 0, 30, 8, 54
"/Users/hehuan/fork/StarForce/Assets/GameFramework/Libraries/GameFramework/Resource/ResourceManager.ReadWriteResourceInfo.cs", "C#", 57, 0, 6, 9, 72
"/Users/hehuan/fork/StarForce/Assets/GameFramework/Libraries/GameFramework/Resource/ResourceManager.ResourceChecker.CheckInfo.CheckStatus.cs", "C#", 21, 0, 27, 7, 55
"/Users/hehuan/fork/StarForce/Assets/GameFramework/Libraries/GameFramework/Resource/ResourceManager.ResourceChecker.CheckInfo.LocalVersionInfo.cs", "C#", 72, 0, 9, 10, 91
"/Users/hehuan/fork/StarForce/Assets/GameFramework/Libraries/GameFramework/Resource/ResourceManager.ResourceChecker.CheckInfo.RemoteVersionInfo.cs", "C#", 90, 0, 9, 12, 111
"/Users/hehuan/fork/StarForce/Assets/GameFramework/Libraries/GameFramework/Resource/ResourceManager.ResourceChecker.CheckInfo.cs", "C#", 189, 0, 81, 25, 295
"/Users/hehuan/fork/StarForce/Assets/GameFramework/Libraries/GameFramework/Resource/ResourceManager.ResourceChecker.cs", "C#", 422, 0, 22, 62, 506
"/Users/hehuan/fork/StarForce/Assets/GameFramework/Libraries/GameFramework/Resource/ResourceManager.ResourceGroup.cs", "C#", 173, 0, 68, 28, 269
"/Users/hehuan/fork/StarForce/Assets/GameFramework/Libraries/GameFramework/Resource/ResourceManager.ResourceGroupCollection.cs", "C#", 177, 0, 50, 27, 254
"/Users/hehuan/fork/StarForce/Assets/GameFramework/Libraries/GameFramework/Resource/ResourceManager.ResourceInfo.cs", "C#", 102, 0, 53, 14, 169
"/Users/hehuan/fork/StarForce/Assets/GameFramework/Libraries/GameFramework/Resource/ResourceManager.ResourceIniter.cs", "C#", 138, 0, 19, 25, 182
"/Users/hehuan/fork/StarForce/Assets/GameFramework/Libraries/GameFramework/Resource/ResourceManager.ResourceLoader.AssetObject.cs", "C#", 115, 0, 9, 18, 142
"/Users/hehuan/fork/StarForce/Assets/GameFramework/Libraries/GameFramework/Resource/ResourceManager.ResourceLoader.LoadAssetTask.cs", "C#", 72, 0, 6, 11, 89
"/Users/hehuan/fork/StarForce/Assets/GameFramework/Libraries/GameFramework/Resource/ResourceManager.ResourceLoader.LoadBinaryInfo.cs", "C#", 67, 0, 6, 9, 82
"/Users/hehuan/fork/StarForce/Assets/GameFramework/Libraries/GameFramework/Resource/ResourceManager.ResourceLoader.LoadDependencyAssetTask.cs", "C#", 47, 0, 6, 8, 61
"/Users/hehuan/fork/StarForce/Assets/GameFramework/Libraries/GameFramework/Resource/ResourceManager.ResourceLoader.LoadResourceAgent.cs", "C#", 277, 0, 40, 45, 362
"/Users/hehuan/fork/StarForce/Assets/GameFramework/Libraries/GameFramework/Resource/ResourceManager.ResourceLoader.LoadResourceTaskBase.cs", "C#", 148, 0, 6, 23, 177
"/Users/hehuan/fork/StarForce/Assets/GameFramework/Libraries/GameFramework/Resource/ResourceManager.ResourceLoader.LoadSceneTask.cs", "C#", 71, 0, 6, 10, 87
"/Users/hehuan/fork/StarForce/Assets/GameFramework/Libraries/GameFramework/Resource/ResourceManager.ResourceLoader.ResourceObject.cs", "C#", 101, 0, 9, 16, 126
"/Users/hehuan/fork/StarForce/Assets/GameFramework/Libraries/GameFramework/Resource/ResourceManager.ResourceLoader.cs", "C#", 665, 0, 162, 117, 944
"/Users/hehuan/fork/StarForce/Assets/GameFramework/Libraries/GameFramework/Resource/ResourceManager.ResourceName.cs", "C#", 120, 0, 24, 25, 169
"/Users/hehuan/fork/StarForce/Assets/GameFramework/Libraries/GameFramework/Resource/ResourceManager.ResourceNameComparer.cs", "C#", 22, 0, 9, 5, 36
"/Users/hehuan/fork/StarForce/Assets/GameFramework/Libraries/GameFramework/Resource/ResourceManager.ResourceUpdater.ApplyInfo.cs", "C#", 105, 0, 51, 14, 170
"/Users/hehuan/fork/StarForce/Assets/GameFramework/Libraries/GameFramework/Resource/ResourceManager.ResourceUpdater.UpdateInfo.cs", "C#", 120, 0, 53, 14, 187
"/Users/hehuan/fork/StarForce/Assets/GameFramework/Libraries/GameFramework/Resource/ResourceManager.ResourceUpdater.cs", "C#", 823, 0, 79, 115, 1017
"/Users/hehuan/fork/StarForce/Assets/GameFramework/Libraries/GameFramework/Resource/ResourceManager.ResourceVerifier.VerifyInfo.cs", "C#", 67, 0, 35, 9, 111
"/Users/hehuan/fork/StarForce/Assets/GameFramework/Libraries/GameFramework/Resource/ResourceManager.ResourceVerifier.cs", "C#", 323, 0, 25, 42, 390
"/Users/hehuan/fork/StarForce/Assets/GameFramework/Libraries/GameFramework/Resource/ResourceManager.VersionListProcessor.cs", "C#", 191, 0, 32, 27, 250
"/Users/hehuan/fork/StarForce/Assets/GameFramework/Libraries/GameFramework/Resource/ResourceManager.cs", "C#", 1768, 0, 503, 317, 2588
"/Users/hehuan/fork/StarForce/Assets/GameFramework/Libraries/GameFramework/Resource/ResourceMode.cs", "C#", 10, 0, 21, 5, 36
"/Users/hehuan/fork/StarForce/Assets/GameFramework/Libraries/GameFramework/Resource/ResourcePackVersionList.Resource.cs", "C#", 99, 0, 48, 14, 161
"/Users/hehuan/fork/StarForce/Assets/GameFramework/Libraries/GameFramework/Resource/ResourcePackVersionList.cs", "C#", 70, 0, 32, 14, 116
"/Users/hehuan/fork/StarForce/Assets/GameFramework/Libraries/GameFramework/Resource/ResourcePackVersionListSerializer.cs", "C#", 14, 0, 16, 4, 34
"/Users/hehuan/fork/StarForce/Assets/GameFramework/Libraries/GameFramework/Resource/ResourceUpdateAllCompleteEventArgs.cs", "C#", 16, 0, 19, 4, 39
"/Users/hehuan/fork/StarForce/Assets/GameFramework/Libraries/GameFramework/Resource/ResourceUpdateChangedEventArgs.cs", "C#", 57, 0, 39, 9, 105
"/Users/hehuan/fork/StarForce/Assets/GameFramework/Libraries/GameFramework/Resource/ResourceUpdateFailureEventArgs.cs", "C#", 57, 0, 40, 9, 106
"/Users/hehuan/fork/StarForce/Assets/GameFramework/Libraries/GameFramework/Resource/ResourceUpdateStartEventArgs.cs", "C#", 65, 0, 43, 10, 118
"/Users/hehuan/fork/StarForce/Assets/GameFramework/Libraries/GameFramework/Resource/ResourceUpdateSuccessEventArgs.cs", "C#", 57, 0, 39, 9, 105
"/Users/hehuan/fork/StarForce/Assets/GameFramework/Libraries/GameFramework/Resource/ResourceVerifyFailureEventArgs.cs", "C#", 25, 0, 23, 5, 53
"/Users/hehuan/fork/StarForce/Assets/GameFramework/Libraries/GameFramework/Resource/ResourceVerifyStartEventArgs.cs", "C#", 33, 0, 27, 6, 66
"/Users/hehuan/fork/StarForce/Assets/GameFramework/Libraries/GameFramework/Resource/ResourceVerifySuccessEventArgs.cs", "C#", 33, 0, 27, 6, 66
"/Users/hehuan/fork/StarForce/Assets/GameFramework/Libraries/GameFramework/Resource/UnloadSceneCallbacks.cs", "C#", 35, 0, 24, 7, 66
"/Users/hehuan/fork/StarForce/Assets/GameFramework/Libraries/GameFramework/Resource/UnloadSceneFailureCallback.cs", "C#", 4, 0, 11, 2, 17
"/Users/hehuan/fork/StarForce/Assets/GameFramework/Libraries/GameFramework/Resource/UnloadSceneSuccessCallback.cs", "C#", 4, 0, 11, 2, 17
"/Users/hehuan/fork/StarForce/Assets/GameFramework/Libraries/GameFramework/Resource/UpdatableVersionList.Asset.cs", "C#", 34, 0, 21, 8, 63
"/Users/hehuan/fork/StarForce/Assets/GameFramework/Libraries/GameFramework/Resource/UpdatableVersionList.FileSystem.cs", "C#", 34, 0, 21, 8, 63
"/Users/hehuan/fork/StarForce/Assets/GameFramework/Libraries/GameFramework/Resource/UpdatableVersionList.Resource.cs", "C#", 97, 0, 49, 15, 161
"/Users/hehuan/fork/StarForce/Assets/GameFramework/Libraries/GameFramework/Resource/UpdatableVersionList.ResourceGroup.cs", "C#", 34, 0, 21, 8, 63
"/Users/hehuan/fork/StarForce/Assets/GameFramework/Libraries/GameFramework/Resource/UpdatableVersionList.cs", "C#", 90, 0, 43, 18, 151
"/Users/hehuan/fork/StarForce/Assets/GameFramework/Libraries/GameFramework/Resource/UpdatableVersionListSerializer.cs", "C#", 14, 0, 16, 4, 34
"/Users/hehuan/fork/StarForce/Assets/GameFramework/Libraries/GameFramework/Resource/UpdateResourcesCompleteCallback.cs", "C#", 4, 0, 11, 2, 17
"/Users/hehuan/fork/StarForce/Assets/GameFramework/Libraries/GameFramework/Resource/UpdateVersionListCallbacks.cs", "C#", 35, 0, 24, 7, 66
"/Users/hehuan/fork/StarForce/Assets/GameFramework/Libraries/GameFramework/Resource/UpdateVersionListFailureCallback.cs", "C#", 4, 0, 11, 2, 17
"/Users/hehuan/fork/StarForce/Assets/GameFramework/Libraries/GameFramework/Resource/UpdateVersionListSuccessCallback.cs", "C#", 4, 0, 11, 2, 17
"/Users/hehuan/fork/StarForce/Assets/GameFramework/Libraries/GameFramework/Resource/VerifyResourcesCompleteCallback.cs", "C#", 4, 0, 10, 2, 16
"/Users/hehuan/fork/StarForce/Assets/GameFramework/Libraries/GameFramework/Scene/ISceneManager.cs", "C#", 32, 0, 104, 25, 161
"/Users/hehuan/fork/StarForce/Assets/GameFramework/Libraries/GameFramework/Scene/LoadSceneDependencyAssetEventArgs.cs", "C#", 57, 0, 39, 9, 105
"/Users/hehuan/fork/StarForce/Assets/GameFramework/Libraries/GameFramework/Scene/LoadSceneFailureEventArgs.cs", "C#", 41, 0, 31, 7, 79
"/Users/hehuan/fork/StarForce/Assets/GameFramework/Libraries/GameFramework/Scene/LoadSceneSuccessEventArgs.cs", "C#", 41, 0, 31, 7, 79
"/Users/hehuan/fork/StarForce/Assets/GameFramework/Libraries/GameFramework/Scene/LoadSceneUpdateEventArgs.cs", "C#", 41, 0, 31, 7, 79
"/Users/hehuan/fork/StarForce/Assets/GameFramework/Libraries/GameFramework/Scene/SceneManager.cs", "C#", 333, 0, 119, 57, 509
"/Users/hehuan/fork/StarForce/Assets/GameFramework/Libraries/GameFramework/Scene/UnloadSceneFailureEventArgs.cs", "C#", 33, 0, 27, 6, 66
"/Users/hehuan/fork/StarForce/Assets/GameFramework/Libraries/GameFramework/Scene/UnloadSceneSuccessEventArgs.cs", "C#", 33, 0, 27, 6, 66
"/Users/hehuan/fork/StarForce/Assets/GameFramework/Libraries/GameFramework/Setting/ISettingHelper.cs", "C#", 37, 0, 142, 28, 207
"/Users/hehuan/fork/StarForce/Assets/GameFramework/Libraries/GameFramework/Setting/ISettingManager.cs", "C#", 38, 0, 146, 29, 213
"/Users/hehuan/fork/StarForce/Assets/GameFramework/Libraries/GameFramework/Setting/SettingManager.cs", "C#", 327, 0, 157, 82, 566
"/Users/hehuan/fork/StarForce/Assets/GameFramework/Libraries/GameFramework/Sound/Constant.cs", "C#", 18, 0, 9, 2, 29
"/Users/hehuan/fork/StarForce/Assets/GameFramework/Libraries/GameFramework/Sound/ISoundAgent.cs", "C#", 93, 0, 91, 27, 211
"/Users/hehuan/fork/StarForce/Assets/GameFramework/Libraries/GameFramework/Sound/ISoundAgentHelper.cs", "C#", 72, 0, 72, 21, 165
"/Users/hehuan/fork/StarForce/Assets/GameFramework/Libraries/GameFramework/Sound/ISoundGroup.cs", "C#", 35, 0, 34, 9, 78
"/Users/hehuan/fork/StarForce/Assets/GameFramework/Libraries/GameFramework/Sound/ISoundGroupHelper.cs", "C#", 6, 0, 9, 2, 17
"/Users/hehuan/fork/StarForce/Assets/GameFramework/Libraries/GameFramework/Sound/ISoundHelper.cs", "C#", 7, 0, 13, 2, 22
"/Users/hehuan/fork/StarForce/Assets/GameFramework/Libraries/GameFramework/Sound/ISoundManager.cs", "C#", 46, 0, 182, 36, 264
"/Users/hehuan/fork/StarForce/Assets/GameFramework/Libraries/GameFramework/Sound/PlaySoundDependencyAssetEventArgs.cs", "C#", 81, 0, 51, 12, 144
"/Users/hehuan/fork/StarForce/Assets/GameFramework/Libraries/GameFramework/Sound/PlaySoundErrorCode.cs", "C#", 12, 0, 27, 7, 46
"/Users/hehuan/fork/StarForce/Assets/GameFramework/Libraries/GameFramework/Sound/PlaySoundFailureEventArgs.cs", "C#", 73, 0, 47, 11, 131
"/Users/hehuan/fork/StarForce/Assets/GameFramework/Libraries/GameFramework/Sound/PlaySoundParams.cs", "C#", 181, 0, 52, 17, 250
"/Users/hehuan/fork/StarForce/Assets/GameFramework/Libraries/GameFramework/Sound/PlaySoundSuccessEventArgs.cs", "C#", 57, 0, 39, 9, 105
"/Users/hehuan/fork/StarForce/Assets/GameFramework/Libraries/GameFramework/Sound/PlaySoundUpdateEventArgs.cs", "C#", 65, 0, 43, 10, 118
"/Users/hehuan/fork/StarForce/Assets/GameFramework/Libraries/GameFramework/Sound/ResetSoundAgentEventArgs.cs", "C#", 17, 0, 19, 4, 40
"/Users/hehuan/fork/StarForce/Assets/GameFramework/Libraries/GameFramework/Sound/SoundManager.PlaySoundInfo.cs", "C#", 64, 0, 6, 9, 79
"/Users/hehuan/fork/StarForce/Assets/GameFramework/Libraries/GameFramework/Sound/SoundManager.SoundAgent.cs", "C#", 283, 0, 100, 39, 422
"/Users/hehuan/fork/StarForce/Assets/GameFramework/Libraries/GameFramework/Sound/SoundManager.SoundGroup.cs", "C#", 205, 0, 70, 29, 304
"/Users/hehuan/fork/StarForce/Assets/GameFramework/Libraries/GameFramework/Sound/SoundManager.cs", "C#", 472, 0, 193, 90, 755
"/Users/hehuan/fork/StarForce/Assets/GameFramework/Libraries/GameFramework/UI/CloseUIFormCompleteEventArgs.cs", "C#", 49, 0, 35, 8, 92
"/Users/hehuan/fork/StarForce/Assets/GameFramework/Libraries/GameFramework/UI/IUIForm.cs", "C#", 41, 0, 74, 18, 133
"/Users/hehuan/fork/StarForce/Assets/GameFramework/Libraries/GameFramework/UI/IUIFormHelper.cs", "C#", 9, 0, 26, 4, 39
"/Users/hehuan/fork/StarForce/Assets/GameFramework/Libraries/GameFramework/UI/IUIGroup.cs", "C#", 41, 0, 65, 16, 122
"/Users/hehuan/fork/StarForce/Assets/GameFramework/Libraries/GameFramework/UI/IUIGroupHelper.cs", "C#", 7, 0, 13, 2, 22
"/Users/hehuan/fork/StarForce/Assets/GameFramework/Libraries/GameFramework/UI/IUIManager.cs", "C#", 80, 0, 250, 53, 383
"/Users/hehuan/fork/StarForce/Assets/GameFramework/Libraries/GameFramework/UI/OpenUIFormDependencyAssetEventArgs.cs", "C#", 81, 0, 51, 12, 144
"/Users/hehuan/fork/StarForce/Assets/GameFramework/Libraries/GameFramework/UI/OpenUIFormFailureEventArgs.cs", "C#", 65, 0, 43, 10, 118
"/Users/hehuan/fork/StarForce/Assets/GameFramework/Libraries/GameFramework/UI/OpenUIFormSuccessEventArgs.cs", "C#", 41, 0, 31, 7, 79
"/Users/hehuan/fork/StarForce/Assets/GameFramework/Libraries/GameFramework/UI/OpenUIFormUpdateEventArgs.cs", "C#", 65, 0, 43, 10, 118
"/Users/hehuan/fork/StarForce/Assets/GameFramework/Libraries/GameFramework/UI/UIManager.OpenUIFormInfo.cs", "C#", 64, 0, 6, 9, 79
"/Users/hehuan/fork/StarForce/Assets/GameFramework/Libraries/GameFramework/UI/UIManager.UIFormInstanceObject.cs", "C#", 43, 0, 9, 9, 61
"/Users/hehuan/fork/StarForce/Assets/GameFramework/Libraries/GameFramework/UI/UIManager.UIGroup.UIFormInfo.cs", "C#", 68, 0, 9, 9, 86
"/Users/hehuan/fork/StarForce/Assets/GameFramework/Libraries/GameFramework/UI/UIManager.UIGroup.cs", "C#", 369, 0, 92, 57, 518
"/Users/hehuan/fork/StarForce/Assets/GameFramework/Libraries/GameFramework/UI/UIManager.cs", "C#", 679, 0, 261, 120, 1060
"/Users/hehuan/fork/StarForce/Assets/GameFramework/Libraries/GameFramework/Utility/Utility.Assembly.cs", "C#", 70, 0, 26, 14, 110
"/Users/hehuan/fork/StarForce/Assets/GameFramework/Libraries/GameFramework/Utility/Utility.Compression.ICompressionHelper.cs", "C#", 17, 0, 37, 6, 60
"/Users/hehuan/fork/StarForce/Assets/GameFramework/Libraries/GameFramework/Utility/Utility.Compression.cs", "C#", 220, 0, 87, 38, 345
"/Users/hehuan/fork/StarForce/Assets/GameFramework/Libraries/GameFramework/Utility/Utility.Converter.cs", "C#", 390, 0, 370, 89, 849
"/Users/hehuan/fork/StarForce/Assets/GameFramework/Libraries/GameFramework/Utility/Utility.Encryption.cs", "C#", 73, 0, 46, 16, 135
"/Users/hehuan/fork/StarForce/Assets/GameFramework/Libraries/GameFramework/Utility/Utility.Json.IJsonHelper.cs", "C#", 16, 0, 26, 5, 47
"/Users/hehuan/fork/StarForce/Assets/GameFramework/Libraries/GameFramework/Utility/Utility.Json.cs", "C#", 76, 0, 30, 14, 120
"/Users/hehuan/fork/StarForce/Assets/GameFramework/Libraries/GameFramework/Utility/Utility.Marshal.cs", "C#", 127, 0, 88, 26, 241
"/Users/hehuan/fork/StarForce/Assets/GameFramework/Libraries/GameFramework/Utility/Utility.Path.cs", "C#", 64, 0, 25, 12, 101
"/Users/hehuan/fork/StarForce/Assets/GameFramework/Libraries/GameFramework/Utility/Utility.Random.cs", "C#", 35, 0, 36, 9, 80
"/Users/hehuan/fork/StarForce/Assets/GameFramework/Libraries/GameFramework/Utility/Utility.Text.ITextHelper.cs", "C#", 28, 0, 361, 17, 406
"/Users/hehuan/fork/StarForce/Assets/GameFramework/Libraries/GameFramework/Utility/Utility.Text.cs", "C#", 206, 0, 365, 51, 622
"/Users/hehuan/fork/StarForce/Assets/GameFramework/Libraries/GameFramework/Utility/Utility.Verifier.Crc32.cs", "C#", 73, 0, 9, 13, 95
"/Users/hehuan/fork/StarForce/Assets/GameFramework/Libraries/GameFramework/Utility/Utility.Verifier.cs", "C#", 130, 0, 42, 24, 196
"/Users/hehuan/fork/StarForce/Assets/GameFramework/Libraries/GameFramework/Utility/Utility.cs", "C#", 6, 0, 9, 2, 17
"/Users/hehuan/fork/StarForce/Assets/GameFramework/Libraries/GameFramework/WebRequest/Constant.cs", "C#", 7, 0, 12, 2, 21
"/Users/hehuan/fork/StarForce/Assets/GameFramework/Libraries/GameFramework/WebRequest/IWebRequestAgentHelper.cs", "C#", 12, 0, 29, 7, 48
"/Users/hehuan/fork/StarForce/Assets/GameFramework/Libraries/GameFramework/WebRequest/IWebRequestManager.cs", "C#", 57, 0, 186, 35, 278
"/Users/hehuan/fork/StarForce/Assets/GameFramework/Libraries/GameFramework/WebRequest/WebRequestAgentHelperCompleteEventArgs.cs", "C#", 25, 0, 24, 6, 55
"/Users/hehuan/fork/StarForce/Assets/GameFramework/Libraries/GameFramework/WebRequest/WebRequestAgentHelperErrorEventArgs.cs", "C#", 25, 0, 23, 5, 53
"/Users/hehuan/fork/StarForce/Assets/GameFramework/Libraries/GameFramework/WebRequest/WebRequestFailureEventArgs.cs", "C#", 49, 0, 35, 8, 92
"/Users/hehuan/fork/StarForce/Assets/GameFramework/Libraries/GameFramework/WebRequest/WebRequestManager.WebRequestAgent.cs", "C#", 116, 0, 38, 23, 177
"/Users/hehuan/fork/StarForce/Assets/GameFramework/Libraries/GameFramework/WebRequest/WebRequestManager.WebRequestTask.cs", "C#", 74, 0, 37, 11, 122
"/Users/hehuan/fork/StarForce/Assets/GameFramework/Libraries/GameFramework/WebRequest/WebRequestManager.WebRequestTaskStatus.cs", "C#", 13, 0, 21, 5, 39
"/Users/hehuan/fork/StarForce/Assets/GameFramework/Libraries/GameFramework/WebRequest/WebRequestManager.cs", "C#", 242, 0, 197, 45, 484
"/Users/hehuan/fork/StarForce/Assets/GameFramework/Libraries/GameFramework/WebRequest/WebRequestStartEventArgs.cs", "C#", 41, 0, 31, 7, 79
"/Users/hehuan/fork/StarForce/Assets/GameFramework/Libraries/GameFramework/WebRequest/WebRequestSuccessEventArgs.cs", "C#", 49, 0, 36, 9, 94
"Total", "-", 30913, 14, 21404, 6514, 58845